Afrika	African	Afrikaner
Antarktis	Antarktis	Antarctican
Amerika	Amerikanischen	Amerikaner
Asien	Asian	Asiaten
Naher Osten	Naher Osten	Des Nahen Ostens
Australien	Australasian	Australasians
Australien	Australian	Australier
Eurasia	Eurasian	Eurasier
Europa	Europäische	Europäer
Nordamerika	North American	Nordamerikaner
Ozeanien	Ozeanische	Ozeanier
Südamerika	Südamerikanisch	Südamerikaner
Abchasien	Abchasen	Abchasischen	Abchasen
Afghanistan	Afghan	Afghanen
Albanien	Albanisch	Albaner
Algerien	Algerischer	Algerier
Amerikanische Samoa	Amerikanisch-Samoas	Amerikanischen Samoans
Andorra	Andorra	Andorraner
Angola	Angolanischen	Angolaner
Anguilla	Anguillan	Anguillans
Antigua und Barbuda	Antigua	Barbudan	Antiguans	Barbudans
Argentinien	Argentine	Argentinischen	Argentinische	Argentinier	Argentinier	Argentinier
Armenien	Armenischen	Armenier
Aruba	Aruba	Arubans
Australien	Australian	Australier	Aussies
Österreich	Austrian	Österreicher
Aserbaidschan	Azerbaijani	Azeri	Aserbaidschaner	Aserbaidschaner
Bahamas	Bahama	Bahamians
Bahrain	Bahrain	Bahrainis
Bangladesch	Bangladesch	Bangladesch
Barbados	Barbados	Barbadians	Bajans
Belarus	Weißrussisch	Weißrussen
Belgien	Belgische	Belgier
Belize	Belize	Belizianer
Benin	Benin	Beninois	Benin	Beninois
Bermuda	Bermudas	Bermudan	Bermudians	Bermudans
Bhutan	Bhutan	Bhutan
Bolivien	Bolivianischen	Bolivianer
Bosnien und Herzegowina	Bosnisch	Bosniak	Herzegowinischen	Bosnier	Bosniaken	Herzegowiner
Botswana	Motswana	Botswanan	Batswana	Botswanans
Brasilien	Brazilian	Brasilianer
British Virgin Islands	Britische Virgin Island	British Virgin Islanders
Brunei	Bruneian	Bruneians
Bulgarien	Bulgarisch	Bulgaren
Burkina Fasoa	Burkinabe	Burkinabe
Burmab	Burmese	Bamar	Burmese
Burundi	Burundi	Burundians
Kambodscha	Kambodschanischen	Kambodschaner
Kamerun	Kameruner	Kameruner
Kanada	Canadian	Kanadier
Cape Verde	Kapverdischen	Kapverdianer
Cayman Islands	Caymanian	Caymanians
Zentralafrikanische Republik	Central African	Zentralafrikanern
Chad	Tschad	Chadians
Chile	Chilenischer	Chilenen
China	Chinesisch	Chinesisch
Weihnachtsinsel	Weihnachtsinsel	Weihnachten Islanders
Cocos (Keeling) Islands	Cocos Island	Cocos Islanders
Kolumbien	Kolumbianischer	Kolumbianer
Komoren	Komoren	Comorians
Dem. Republik Kongo	Kongolesen	Kongo	Kongolesen
Cook Islands	Cook-Inseln	Cook-Insulaner
Costa Rica	Costa Rica	Costa Ricaner	Ticos
Côte d'Ivoire	Ivorischen	Ivorer
Kroatien	Kroatisch	Kroaten	Kroaten
Kuba	Cuban	Kubaner
Zypern	Zypriotischen	Zyprioten
Tschechische Republik	Czech	Tschechen
Dänemark	Danish	Dänen
Djibouti	Dschibuti	Djiboutians
Dominica	Dominikanische	Dominicansd
Dominikanische Republik	Dominikanische	Dominicanse	Quisqueyanos
Osttimor	Timor-Leste	Timor-Leste	Maubere
Ecuador	Ecuadorianischen	Ecuadorianer
Ägypten	Ägyptisch	Ägypter
El Salvador	Salvador	Salvadorianer
England	Englisch	Englisch
Äquatorial-Guinea	Äquatorial-Guinea	Equatoguinean	Äquatorial-Guinea	Equatoguineans
Eritrea	Eritreischen	Eritreer
Estland	Estnische	Esten
Äthiopien	Ethiopian	Äthiopier
Falkland-Inseln	Falkland Island	Falkland Islanders	Belongers
Färöer-Inseln	Färöisch	Färöisch
Fidschi	Fidschi	Fijians
Finnland	Finnisch	Finnen
Frankreich	Französisch	Französisch
Französisch-Guayana	Französisch Guayana	Französisch Guayana
Französisch-Polynesien	Französisch-Polynesien	Französisch Polynesien
Gabun	Gabun	Gabun
Gambia	Gambia	Gambians
Georgia	Georgian	Georgier
Deutschland	Deutsch	Deutschen
Ghana	Ghanaischen	Ghanaer
Gibraltar	Gibraltar	Gibraltarians	Llanitos
Großbritannien	Britisch	Briten
Griechenland	Griechisch	Grecian	Hellenic	Griechen	Greciansf	Hellenen
Grönland	Grönländischen	Grönländer
Grenada	Grenada	Grenadians
Guadeloupe	Guadeloupe	Guadeloupians
Guam	Guamanian	Guamanians
Guatemala	Guatemaltekischen	Guatemalteken
Guinea	Guineas	Guineaner
Guyana	Guyana	Guyana
Haiti	Haitian	Haitianer	Ayisyen
Honduras	Honduranischen	Honduras	Catrachos
Hong Kong	Hong Kong	Hongkongese	Hongkongers	Hongkongese	Hongers
Ungarn	Ungarisch	Magyar	Ungarn	Magyaren
Island	Icelandic	Isländer
Indien	Indian	Indianer
Indonesien	Indonesische	Indonesier
Iran	Iranian	Iraner
Irak	Irakischer	Iraker
Irland	Irish	Irish
Isle of Man	Manx	Manx
Israel	Israeli	Israelis
Italien	Italienisch	Kursiv	Italiener	Italicsf
Jamaica	Jamaican	Jamaikaner
Japan	Japanisch	Japanisch
Jordan	Jordanischer	Jordanier
Kasachstan	Kasachisch	Kasachische	Kazakhstanis	Kasachen
Kenia	Kenia	Kenianer
Kiribati	Kiribati	I-Kiribati
Nordkorea	Nordkoreas	Koreaner
Südkorea	Südkoreanischer
Kosovo	Kosovo	Kosovaren
Kuwait	Kuwait	Kuwaitis
Kirgisistan	Kirgisischen	Kirgisischen	Kirgisen	Kirgisen	Kyrgyzstanis	Kirgisischen	Kirgisen	Kirgisen
Laos	Laotischen	Lao	Laoten	Laos
Lettland	Lettisch	Letten	Letts
Libanon	Libanesen	Libanesen
Lesotho	Basotho	Basotho
Liberia	Liberianischen	Liberiere
Libyen	Libyscher	Libyer
Liechtenstein	Liechtenstein	Liechtensteiner
Litauen	Litauisch	Litauer
Luxemburg	Luxemburg	Luxemburger
Macau	Macanese	Chinesisch	Macanese	Chinesisch
Republik Mazedonien	Mazedonien	Mazedonier
Madagaskar	Malagasy	Malagasy
Malawi	Malawi	Malawians
Malaysia	Malaysian	Malaysier
Malediven	Malediven	Maldivians
Mali	Malischen	Malians
Malta	Maltese	Maltese
Marshall Islands	Marshallese	Marshallese
Martinique	Martiniquais	Martinique	Martiniquais
Mauretanien	Mauretanischen	Mauritanians
Mauritius	Mauritius	Mauritians
Mayotte	Mahoran	Mahorais
Mexiko	Mexican	Mexikaner
Mikronesien	Micronesian	Mikronesier
Moldawien	Moldovan	Moldawier
Monaco	Monégasque	Monacan	Monegassen	Monacans
Mongolei	Mongolian	Mongolen	Mongolen
Montenegro	Montenegrinischen	Montenegriner
Montserrat	Montserratian	Montserratians
Marokko	Marokkanischer	Marokkaner
Mosambik	Mosambikanischen	Mosambikaner
Namibia	Namibischer	Namibier
Nauru	Nauruan	Nauruans
Nepal	Nepali	Nepalesische
Niederlande	Dutch	Dutch
Niederländische Antillen	Niederländischen Antillen	Niederländisch Antillen
Neukaledonien	New Caledonian	Neukaledonier
Neuseeland	Neuseeland	Neuseeländer	Kiwis
Nicaragua	Nicaragua	Nicaraguaner
Niue	Niuean	Niueans
Niger	Niger	Nigeriens
Nigeria	Nigerianische	Nigerianer
Norwegen	Norwegian	Norweger
Nordirland	Northern Irish / Irish	Irisch / nordirischen
Nördliche Marianen	Northern Marianan	Northern Marianans
Oman	Omanische	Omanis
Pakistan	Pakistanische	Pakistanis
Palästinensischen Gebieten	Palästinensischen	Palästinenser
Palau	Palau	Palauans
Panama	Panama	Panamanians
Papua-Neuguinea	Papua-Neuguinea	Papua	Papua-Neuguinea	Papuas
Paraguay	Paraguay	Paraguayer
Peru	Peruanischen	Peruaner
Philippinen	Philippine	Filipino	Filipinos Pinoys
Pitcairn-Insel	Pitcairn-Insel	Pitcairn Islanders
Polen	Polnisch	Polen
Portugal	Portugiesisch	Portugiesisch
Puerto Rico	Puerto Rico	Puertoricaner	Boricuas
Qatar	Katar	Qataris
Republik Irland	Irish / Southern Irish g	Irish / Southern Irish g
Réunion	Reunionesischen	Réunionnais	Reunionesischen	Réunionnais
Rumänien	Rumänisch	Rumänen
Russland	Russisch	Russen
Ruanda	Ruandischen	Ruander
St. Helena	St. Helenian	St. Helenians
St. Kitts und Nevis	Kittitian	Nevisian	Kittitians	Nevisians
St. Lucia	St. Lucian	St. Lucians
Saint-Pierre und Miquelon	Saint-Pierrais	Miquelonnais	Saint-Pierrais	Miquelonnais
St. Vincent und die Grenadinen	St. Vinzenz	Vincentian	St. Vincentians	Vincentians
Samoa	Samoa	Samoaner
San Marino	Sammarinese	Sammarinese
São Tomé und Príncipe	São Tomé und Príncipe	São Tomeans
Saudi-Arabien	Saudi	Saudi Arabian	Saudis	Saudi-Araber
Schottland	Schotten	Scottish	Scotch	Schotten
Senegal	Senegalesischen	Senegalesischen
Serbien	Serbisch	Serben	Serben
Seychellen	Seychellen	Seychellen
Sierra Leone	Sierra Leone	Sierra Leone
Singapur	Singapur	Singapurer
Slowakei	Slovak	Slowaken
Slowenien	Slowenisch	Slowenisch	Slowenen	Slowenen
Solomon Islands	Solomon Island	Solomon Islanders
Somalia	Somali	Somalis
Südafrika	South African	Südafrikaner
Südossetien	Südossetischen	Südossetier
Spanien	Spanisch	Spanier
Sri Lanka	Sri Lanka	Sri Lanka
Sudan	Sudanesischen	Sudanesischen
Surinam	Surinam	Surinamers
Swaziland	Swazi	Swazis
Schweden	Schwedisch	Schweden
Schweiz	Swiss	Swiss
Syrien	Syrische	Syrer
Taiwan	Taiwanese	Taiwanese
Tadschikistan	Tajikistani	Tajikistanis	Tadschiken
Tansania	Tansania	Tansanier
Thailand	Thai	Thai
Togo	Togo	Togo
Tonga	Tonga	Tongans
Trinidad und Tobago	Trinidadian	Tobagonian	Trinidadians	Tobagonians	Trinis
Tunesien	Tunesischer	Tunesier
Türkei	Türkisch	Türken
Turkmenistan	Turkmenischen	Turkmenen
Tuvalu	Tuvaluan	Tuvaluans
Uganda	Uganda	Ugander
Ukraine	Ukrainisch	Ukrainer
Vereinigte Arabische Emirate	Emirate	Emirian	Emiratis	Emirians
Großbritannien	Britisch	Briten
Vereinigte Staaten von Amerika	Amerikanischen	US	Amerikanischen
Uruguay	Uruguayischen	Uruguayer
Usbekistan	Usbekischen	Usbekische	Usbeken	Usbeken
Vanuatu	Ni-Vanuatu	Vanuatuan	Ni-Vanuatu
Venezuela	Venezolanischen	Venezolaner
Vietnam	Vietnamesisch	Vietnamesisch
Virgin Islands	Virgin Island	Virgin Islanders
Wales	Welsh	Welsh
Wallis und Futuna	Wallisian	Futunan	Wallisians	Futunans
Westsahara	Sahraw	Sahrawian	Sahraouian	Sahrawis	Sahraouis
Jemen	Jemen	Jemeniten
Jugoslawien	Jugoslawischen	Jugoslawen
Sambia	Sambia	Zambians
Simbabwe	Simbabwe	Simbabwer
