aacht	MALE
aachte	MALE
aad	MALE
aaf	MALE
aafko	MALE
aagje	FEMALE
aaielt	MALE
aaike	FEMALE
aaike	MALE
aaildert	MALE
aailert	MALE
aailt	MALE
aaiolt	MALE
aaite	MALE
aaize	MALE
aalderd	MALE
aalderik	MALE
aalderk	MALE
aaldert	MALE
aaldrik	MALE
aaliyah	FEMALE
aalje	MALE
aalk	MALE
aalse	MALE
aalt	MALE
aaltienus	MALE
aalzen	MALE
aanke	MALE
aant	MALE
aaricia	FEMALE
aarke	MALE
aarn	MALE
aarnoud	MALE
aarnout	MALE
aaron	MALE
aart	MALE
aart-jan	MALE
aat	MALE
aauwke	MALE
ab	MALE
abadiaha	MALE
abbe	MALE
abbo	MALE
abdoel	MALE
abdoellah	MALE
abdoulaye	MALE
abdul	MALE
abdul-jabar	MALE
abdulla	MALE
abdullah	MALE
abe	MALE
abel	MALE
abele	MALE
abelone	MALE
abhartach	MALE
abi	MALE
abigael	FEMALE
abigail	FEMALE
abke	MALE
abner	MALE
abo	MALE
abraham	MALE
abraham joseph	MALE
abrahán	MALE
abram	MALE
abramo	MALE
abry	MALE
abrán	MALE
abs	MALE
aby	MALE
abyote	MALE
aca	MALE
acco	MALE
acelya	FEMALE
achaz	MALE
acheloös	MALE
achiel	MALE
achille	MALE
achilles	MALE
achilleus	MALE
achillus	MALE
achior	MALE
achmed	MALE
acronius	MALE
ad	MALE
ada	FEMALE
adair	MALE
adalar	MALE
adam	MALE
adde	MALE
addick	MALE
addie	MALE
addik	MALE
addike	MALE
addis	MALE
addison	MALE
addo	MALE
ade	FEMALE
ade	MALE
adel	MALE
adelain	MALE
adelbert	MALE
adelbrand	MALE
adele	FEMALE
adelhard	MALE
adelhart	MALE
adelin	MALE
adeline	FEMALE
adelmar	MALE
adelwald	MALE
adelwalt	MALE
adelwijn	MALE
ademaro	MALE
ademo	MALE
adeodato	MALE
aderick	MALE
aderik	MALE
ades	MALE
adger	MALE
adhamhnan	MALE
adik	MALE
adil	MALE
adin	MALE
adinda	FEMALE
adio	MALE
adir	MALE
adjan	MALE
adjay	MALE
adje	MALE
admon	MALE
adnan	MALE
adne	MALE
adney	MALE
ado	MALE
adolf	MALE
adolfo	MALE
adolphe	MALE
adon	MALE
adonis	MALE
adrastos	MALE
adri	MALE
adriaan	MALE
adriaen	MALE
adrian	MALE
adriana	FEMALE
adriano	MALE
adrianus	MALE
adrie	MALE
adries	MALE
adryon	MALE
adsje	MALE
adwin	MALE
adzer	MALE
adé	MALE
aebe	MALE
aebel	MALE
aedan	MALE
aedil	MALE
aef	MALE
aeger	MALE
aegidius	MALE
aeije	MALE
aeijolt	MALE
aeike	MALE
aeiko	MALE
aeilt	MALE
aeiold	MALE
aeisso	MALE
aeldert	MALE
aelssen	MALE
aelt	MALE
aelwyn	MALE
aem	MALE
aemeling	MALE
aemilius	MALE
aendrik	MALE
aeneas	MALE
aengus	MALE
aerde	MALE
aerjen	MALE
aerke	MALE
aern	MALE
aernold	MALE
aernout	MALE
aernt	MALE
aert	MALE
aerte	MALE
afgaritano	MALE
afonso	MALE
afra	FEMALE
afton	MALE
age	MALE
agenoor	MALE
agge	MALE
aghy	MALE
agilbert	MALE
agim	MALE
aginhari	MALE
agmund	MALE
agnar	MALE
agnes	FEMALE
agnetha	FEMALE
ago	MALE
agostin	MALE
agus	MALE
ahlam	FEMALE
ahmed	MALE
ahran	MALE
aias	MALE
aibel	MALE
aicha	FEMALE
aichlinn	MALE
aico	MALE
aidan	MALE
aide	MALE
aiden	MALE
aidi	FEMALE
aido	MALE
aienius	MALE
aietes	MALE
aigus	MALE
aijeld	MALE
aijolt	MALE
aike	MALE
aiken	MALE
aikenius	MALE
aiko	FEMALE
aiko	MALE
ailbe	MALE
ailbhe	MALE
ailbhis	MALE
aile	MALE
ailill	MALE
ailin	MALE
ailje	MALE
ailke	MALE
ailko	MALE
aiman	MALE
aime	MALE
aimee	FEMALE
aimirgin	MALE
aimy	FEMALE
aimée	FEMALE
aineias	MALE
ainhoa	FEMALE
ainle	MALE
ainmire	MALE
ainsley	MALE
aiold	MALE
aiolos	MALE
aisa	FEMALE
aischa	FEMALE
aisha	FEMALE
aiso	MALE
aissatou	FEMALE
aisso	MALE
ait	MALE
aite	MALE
aito	MALE
aitse	MALE
aitze	MALE
aize	MALE
aizo	MALE
ajax	MALE
ajeld	MALE
ajla	FEMALE
ajolt	MALE
ajoy	MALE
ake	MALE
akif	MALE
akim	MALE
akira	MALE
akis	MALE
akrisios	MALE
aksel	MALE
aktaison	MALE
al	MALE
aladar	MALE
alain	MALE
alajos	MALE
alan	MALE
alana	FEMALE
alanah	FEMALE
aland	MALE
alani	FEMALE
alanis	FEMALE
alano	MALE
alant	MALE
alara	FEMALE
alard	MALE
alastair	MALE
alastar	MALE
alayah	FEMALE
alban	MALE
albanus	MALE
alber	MALE
alberich	MALE
alberico	MALE
alberik	MALE
albert	MALE
albert-john	MALE
albertin	MALE
albertino	MALE
alberto	MALE
albertus	MALE
albin	MALE
albina	FEMALE
albot	MALE
albrekt	MALE
albéric	MALE
alco	MALE
aldemar	MALE
alderik	MALE
alderk	MALE
aldert	MALE
aldo	MALE
aldon	MALE
aldous	MALE
aldrick	MALE
aldridge	MALE
aldrin	MALE
aldwin	MALE
ale	MALE
alec	MALE
alef	MALE
alejandra	FEMALE
alejandro	MALE
alek	MALE
alekos	MALE
aleks	MALE
aleksandr	MALE
aleksi	MALE
alemondo	MALE
alend	MALE
alert	MALE
alesander	MALE
alessa	FEMALE
alessandra	FEMALE
alessandro	MALE
alessia	FEMALE
alessio	MALE
alette	FEMALE
alex	FEMALE
alex	MALE
alexander	MALE
alexandra	FEMALE
alexandre	MALE
alexine	FEMALE
alexio	MALE
alexis	MALE
alexius	MALE
alexsander	MALE
aleyna	FEMALE
alf	MALE
alfano	MALE
alfard	MALE
alfert	MALE
alfeu	MALE
alfons	MALE
alfonso	MALE
alfre	MALE
alfred	MALE
alfredo	MALE
alger	MALE
ali	MALE
alia	FEMALE
alian	MALE
alic	MALE
alice	FEMALE
alice	FEMALE
alicia	FEMALE
alides	MALE
alieke	FEMALE
alina	FEMALE
aline	FEMALE
aling	MALE
alisa	FEMALE
alisha	FEMALE
alisia	FEMALE
alison	FEMALE
alissa	FEMALE
alissia	FEMALE
alistair	MALE
alister	MALE
alix	FEMALE
alix	MALE
alixe	FEMALE
aliya	FEMALE
aliyah	FEMALE
alizee	FEMALE
alje	MALE
aljen	MALE
aljon	MALE
aljoscha	MALE
alke	MALE
alker	MALE
alkinoös	MALE
alko	MALE
alkwin	MALE
allan	MALE
allard	MALE
allart	MALE
alle	MALE
allecio	MALE
allejan	MALE
allerd	MALE
allert	MALE
allesandro	MALE
allian	MALE
allon	MALE
ally	MALE
allyssia	FEMALE
alma	FEMALE
almando	MALE
almar	MALE
almon	MALE
alof	MALE
alois	MALE
aloisio	MALE
alon	MALE
alonso	MALE
alonzo	MALE
aloys	MALE
alphonds	MALE
alphons	MALE
alquin	MALE
alrik	MALE
alt	MALE
alte	MALE
altinus	MALE
alto	MALE
alton	MALE
alvan	MALE
alvaro	MALE
alve	MALE
alves	MALE
alvin	MALE
alvinho	MALE
alwin	MALE
alwyn	MALE
alycia	FEMALE
alysha	FEMALE
alysia	FEMALE
alyssa	FEMALE
alyssia	FEMALE
alyzee	FEMALE
amaar	MALE
amaat	MALE
amadeo	MALE
amadeus	MALE
amal	FEMALE
amal	MALE
amalgaid	MALE
amalgith	MALE
amalia	FEMALE
aman	MALE
amand	MALE
amanda	FEMALE
amande	FEMALE
amandine	FEMALE
amandus	MALE
amani	FEMALE
amar	MALE
amaranto	MALE
amargein	MALE
amarins	MALE
amaryllis	FEMALE
amato	MALE
amatus	MALE
amaury	FEMALE
amaury	MALE
amayam	FEMALE
amber	FEMALE
amberly	FEMALE
ambre	FEMALE
ambro	MALE
ambroggio	MALE
ambrogio	MALE
ambrose	MALE
ambrosio	MALE
amco	MALE
ame	MALE
amedee	MALE
amel	FEMALE
amel	MALE
amele	MALE
amelia	FEMALE
amelie	FEMALE
amelien	FEMALE
ameline	FEMALE
ameling	MALE
amely	FEMALE
amerigo	MALE
amfiaros	MALE
amfioon	MALE
amfitryoon	MALE
amilcare	MALE
amilie	FEMALE
amina	FEMALE
amir	MALE
amira	FEMALE
amit	MALE
amke	FEMALE
amke	MALE
amko	MALE
amme	MALE
ammo	MALE
amon	MALE
amos	MALE
amparo	MALE
amrish	MALE
amrit	MALE
amse	MALE
amund	MALE
amy	FEMALE
amze	MALE
an	FEMALE
an sofie	FEMALE
ana	FEMALE
anaelle	FEMALE
anahit	FEMALE
anais	FEMALE
anand	MALE
anas	MALE
anastacia	FEMALE
anastasia	FEMALE
anastasio	MALE
anatoie	MALE
anchises	MALE
anco	MALE
andel	MALE
andele	MALE
anderijus	MALE
anders	MALE
andert	MALE
andle	MALE
andoni	MALE
andor	MALE
andrais	MALE
andras	MALE
andre	MALE
andrea	FEMALE
andrea	MALE
andreas	MALE
andrees	MALE
andres	MALE
andress	MALE
andrew	MALE
andri	MALE
andries	MALE
andrijs	MALE
andro	MALE
andrés	MALE
andy	MALE
ane	MALE
ange	MALE
angel	FEMALE
angela	FEMALE
angelico	MALE
angelina	FEMALE
angelique	FEMALE
angelita	FEMALE
angelo	MALE
angelos	MALE
angely	FEMALE
angert	MALE
angie	FEMALE
angil	MALE
angy	FEMALE
aniek	FEMALE
anies	MALE
anika	FEMALE
anil	MALE
anisa	FEMALE
anish	MALE
anisha	FEMALE
anissa	FEMALE
anita	FEMALE
anjo	MALE
anka	FEMALE
anke	FEMALE
anko	MALE
anky	FEMALE
anmchadh	MALE
ann	FEMALE
ann sofie	FEMALE
ann sophie	FEMALE
anna	FEMALE
annabel	FEMALE
annabelle	FEMALE
annalisa	FEMALE
annamarijn	MALE
anne	FEMALE
anne	MALE
anne catherine	FEMALE
anne fleur	FEMALE
anne laure	FEMALE
anne marie	FEMALE
anne sofie	FEMALE
anne sophie	FEMALE
anne-mark	MALE
annegreet	FEMALE
anneke	FEMALE
anneleen	FEMALE
annelien	FEMALE
annelies	FEMALE
annelin	FEMALE
annelore	FEMALE
annemarie	FEMALE
annemiek	FEMALE
annemieke	FEMALE
annemijn	FEMALE
anner	MALE
annette	FEMALE
annibale	MALE
annika	FEMALE
anno	MALE
annold	MALE
anoek	FEMALE
anoeshka	FEMALE
anou	FEMALE
anouar	MALE
anouchka	FEMALE
anouck	FEMALE
anouk	FEMALE
anoushka	FEMALE
anrico	MALE
ans	FEMALE
ansco	MALE
anse	FEMALE
anse	MALE
ansel	MALE
anselm	MALE
anselmo	MALE
anselmus	MALE
ansgar	MALE
anske	MALE
ant	MALE
antaios	MALE
antal	MALE
ante	FEMALE
ante	MALE
antek	MALE
anthe	FEMALE
anthoney	MALE
anthonie	MALE
anthonin	MALE
anthonius	MALE
anthony	MALE
antinoös	MALE
antje	FEMALE
antogoni	MALE
antoin	MALE
antoine	MALE
antois	MALE
anton	MALE
antonello	MALE
antonia	FEMALE
antonie	MALE
antonino	MALE
antonio	MALE
antonius	MALE
antony	MALE
antoon	MALE
antoon	MALE
antti	MALE
antwan	MALE
anvar	MALE
anwar	MALE
anyssa	FEMALE
aodh	MALE
aodhan	MALE
aodhan	MALE
aodhfionn	MALE
aonghus	MALE
aout	MALE
ap	MALE
apke	MALE
apolionius	MALE
apolline	FEMALE
apolloon	MALE
appie	MALE
aptrick	MALE
aquiles	MALE
ar	MALE
araldo	MALE
aram	MALE
aranka	FEMALE
arantes	MALE
arantez	MALE
arash	MALE
aravint	MALE
arber	MALE
arbo	MALE
arby	MALE
archibald	MALE
archie	MALE
arco	MALE
arcon	MALE
ard	MALE
ardal	MALE
arden	MALE
ardian	MALE
ardin	MALE
ardjan	MALE
ardo	MALE
arduino	MALE
ardy	MALE
are	MALE
arend	MALE
arend-jan	MALE
arendina	FEMALE
arendo	MALE
arent	MALE
ares	MALE
arex	MALE
arezina	FEMALE
argos	MALE
aria	FEMALE
ariaan	MALE
ariadne	FEMALE
arian	MALE
ariana	FEMALE
arianna	FEMALE
arianne	FEMALE
ariberto	MALE
arid	MALE
arie	MALE
arielle	FEMALE
arien	MALE
arij	MALE
arik	MALE
arino	MALE
arinze	MALE
aris	MALE
aristaios	MALE
aristariqe	MALE
aristide	MALE
aristides	MALE
aristoteles	MALE
ariël	MALE
arjaan	MALE
arjan	MALE
arjana	FEMALE
arjen	MALE
arjo	MALE
arjon	MALE
arjé	MALE
arke	MALE
arko	MALE
arlend	MALE
arlo	MALE
arman	MALE
armand	MALE
armando	MALE
armel	MALE
armijn	MALE
armin	MALE
armindo	MALE
armon	MALE
armond	MALE
armyan	MALE
arnaldo	MALE
arnando	MALE
arnaud	MALE
arne	MALE
arne-sivar	MALE
arnel	MALE
arnhold	MALE
arnie	MALE
arniko	MALE
arno	MALE
arnold	MALE
arnolf	MALE
arnolfo	MALE
arnoud	MALE
arnoul	MALE
arnould	MALE
arnout	MALE
aro	MALE
aroen	MALE
arold	MALE
aron	MALE
arpi	MALE
arre	MALE
arrezina	FEMALE
arrien	MALE
arrigo	MALE
arris	MALE
arsalan	MALE
arse	MALE
arseen	MALE
arsenio	MALE
arsené	MALE
arso	MALE
arsène	MALE
art	MALE
artem	MALE
arthgallo	MALE
arthon	MALE
arthur	MALE
arthy	MALE
artjom	MALE
artole	MALE
artur	MALE
arturo	MALE
arun	MALE
aruna	FEMALE
arvid	MALE
arvin	MALE
arvind	MALE
arwed	MALE
arwen	FEMALE
arwen	MALE
arwin	MALE
aryan	MALE
aryans	MALE
aschwin	MALE
ase	MALE
asel	FEMALE
ashanti	FEMALE
ashil	MALE
ashley	FEMALE
ashon	MALE
ashow	MALE
ashvind	MALE
ashwin	MALE
askanois	MALE
askim	MALE
askon	MALE
asli	FEMALE
aslihan	FEMALE
asma	FEMALE
asmaa	FEMALE
asmae	FEMALE
asmar	MALE
asmes	MALE
aspos	MALE
asrael	MALE
asscher	MALE
assel	MALE
assia	FEMALE
assu	MALE
aster	FEMALE
asthon	MALE
astin	MALE
astrid	FEMALE
astyanax	MALE
aswin	MALE
asya	FEMALE
ataigh	MALE
ate	MALE
athamas	MALE
athan	MALE
athena	FEMALE
athina	FEMALE
athol	MALE
atilla	MALE
atje	MALE
atlas	MALE
ato	MALE
atreus	MALE
atse	MALE
atsert	MALE
atte	MALE
attila	MALE
attje	MALE
atze	MALE
atzema	MALE
aube	FEMALE
aubert	MALE
aubin	MALE
aubrey	MALE
aude	FEMALE
auden	MALE
audrey	FEMALE
audy	MALE
aue	MALE
augias	MALE
augosto	MALE
august	MALE
augustine	MALE
augustus	MALE
auke	FEMALE
auke	MALE
aukelien	FEMALE
aukje	FEMALE
auko	MALE
aureel	MALE
aurelie	FEMALE
aureline	FEMALE
aurelio	MALE
aurelius	MALE
aurora	FEMALE
aurore	FEMALE
austin	MALE
auwe	MALE
auwen	MALE
auwert	MALE
auwke	MALE
auwko	MALE
ava	FEMALE
ave	MALE
averardo	MALE
avital	MALE
avo	MALE
awa	FEMALE
awley	MALE
awnan	MALE
axana	FEMALE
axel	MALE
axelle	FEMALE
aya	FEMALE
ayah	FEMALE
ayca	FEMALE
ayco	FEMALE
aydin	MALE
aye	MALE
ayeld	MALE
ayesta	FEMALE
ayke	MALE
ayko	FEMALE
ayla	FEMALE
aylin	FEMALE
ayline	FEMALE
ayllas	MALE
aymar	MALE
ayo	MALE
ayold	MALE
ayrton	MALE
ayse	FEMALE
ayse	MALE
aysegul	FEMALE
aysel	MALE
aysenur	FEMALE
ayton	MALE
ayu	FEMALE
ayub	MALE
ayzo	MALE
aza	FEMALE
azize	FEMALE
azoon	MALE
azra	FEMALE
azzedine	MALE
azzing	MALE
azziz	MALE
azzo	MALE
baafje	FEMALE
baafke	FEMALE
baak	MALE
baals	MALE
baalster	MALE
baatje	MALE
baauw	MALE
baauwe	MALE
baauwke	MALE
baauwkien	MALE
bab	FEMALE
babat	FEMALE
babet	FEMALE
babeth	FEMALE
babethe	FEMALE
babette	FEMALE
babice	FEMALE
babiche	FEMALE
baboeskha	FEMALE
babs	FEMALE
bachar	MALE
badia	FEMALE
baef	MALE
baeke	MALE
baen	MALE
baerbel	FEMALE
baerd	MALE
baernd	MALE
baernt	MALE
baert	MALE
baeu-noël	MALE
bahaara	FEMALE
bahar	MALE
bailey	MALE
baillgheal	FEMALE
bain	MALE
baindu	FEMALE
bairbre	FEMALE
bairrionn	FEMALE
bakchos	MALE
bake	MALE
bakke	MALE
baldassare	MALE
balde	MALE
balder	MALE
baldine	FEMALE
baldovino	MALE
balduino	MALE
baldwin	MALE
bale	MALE
baling	MALE
balki	MALE
balle	MALE
balling	MALE
baloe	MALE
balou	FEMALE
balta	FEMALE
balte	MALE
balthasar	MALE
balthazar	MALE
baltsar	MALE
baltser	MALE
bam	MALE
bambi	FEMALE
bambina	FEMALE
bame	MALE
bamse	MALE
banba	FEMALE
banbha	FEMALE
banbhnait	FEMALE
bandy	MALE
bane	MALE
banne	MALE
banu	FEMALE
bape	MALE
bapke	FEMALE
baptist	MALE
baran	MALE
barbara	FEMALE
barbarius	MALE
barbel	FEMALE
barber	FEMALE
barbera	FEMALE
barbertje	FEMALE
barbie	FEMALE
barbra	FEMALE
bard	MALE
bareld	MALE
barend	MALE
barendina	FEMALE
barett	MALE
barld	MALE
barnabas	MALE
barnabé	MALE
barnes	MALE
barny	MALE
barran	FEMALE
barre	MALE
barri	FEMALE
barry	MALE
bart	MALE
bart-jan	MALE
bart-jeroen	MALE
bartel	MALE
barteld	MALE
bartele	MALE
barteliene	FEMALE
barteltsje	MALE
barten	MALE
barthel	MALE
bartho	MALE
bartholo	MALE
bartholomeus	MALE
barto	MALE
bartolomeo	MALE
bartolomé	MALE
barty	FEMALE
barty	MALE
baruch	MALE
bas	MALE
bashir	MALE
basiaana	FEMALE
basiaana	MALE
basiel	MALE
basil	MALE
basileia	FEMALE
basilius	MALE
basit	MALE
basjan	MALE
basje	FEMALE
basse	FEMALE
basten	MALE
bastiaan	MALE
bastiaantje	FEMALE
bastian	MALE
bastiano	MALE
bastien	MALE
bastienne	FEMALE
basto	MALE
bate	MALE
bathilda	FEMALE
bathilde	FEMALE
bathina	FEMALE
bathseba	FEMALE
batilda	FEMALE
batilde	FEMALE
battista	MALE
battistino	MALE
baud	MALE
baudouin	MALE
baue	MALE
bauke	MALE
bauke-jan	MALE
baukis	FEMALE
baukje	FEMALE
bautista	MALE
bauwe	MALE
bauwina	FEMALE
bauwke	FEMALE
bavo	MALE
baypolat	MALE
bea	FEMALE
beake	MALE
bealt	MALE
bean	MALE
beanca	FEMALE
beant	MALE
bear	MALE
bearnt	MALE
bearrach	FEMALE
beart	MALE
beata	FEMALE
beate	FEMALE
beatha	FEMALE
beato	MALE
beatrice	FEMALE
beatrijs	FEMALE
beatrix	FEMALE
beau	FEMALE
beau	MALE
beaudine	FEMALE
beaulieu	FEMALE
beauty	FEMALE
beauwe	MALE
bebhaill	FEMALE
beborah	FEMALE
beck	MALE
beckett	MALE
becky	FEMALE
beenes	MALE
beer	MALE
beerend	MALE
beernd	MALE
beert	MALE
beertje	FEMALE
beeuw	MALE
beeuwe	MALE
behrend	MALE
beie	MALE
beije	MALE
beike	FEMALE
bein	MALE
beine	MALE
beint	MALE
beinte	MALE
beintse	MALE
beitse	MALE
beitske	FEMALE
bekka	FEMALE
belia	FEMALE
belicia	FEMALE
belieke	FEMALE
belinda	FEMALE
bella	FEMALE
belle	FEMALE
bellissa	FEMALE
belt	MALE
beltrán	MALE
bemarean	FEMALE
ben	MALE
benaissa	MALE
bence	MALE
bende	MALE
bendert	MALE
bendetta	FEMALE
bendiks	MALE
bendt	MALE
bene	MALE
benedetta	FEMALE
benedetto	MALE
benedic	MALE
benedict	MALE
benedicta	FEMALE
benedicto	MALE
benedictus	MALE
benedikta	FEMALE
benert	MALE
benevenuto	MALE
bengt	MALE
bengta	FEMALE
bengte	FEMALE
beniaminito	MALE
beniamino	MALE
benice	FEMALE
benine	FEMALE
bening	MALE
benita	FEMALE
benito	MALE
benja	FEMALE
benjamin	MALE
benjamina	FEMALE
benjamine	FEMALE
benji	MALE
benjo	MALE
benk	MALE
benke	MALE
bennadette	FEMALE
benne	MALE
bennet	MALE
bennie	MALE
benno	MALE
benny	MALE
beno	MALE
bense	MALE
benso	MALE
bent	MALE
bente	FEMALE
bente	MALE
benten	MALE
benthe	FEMALE
benthel	FEMALE
bento	MALE
benzo	MALE
bep	FEMALE
beppe	MALE
beppie	FEMALE
ber	MALE
beracha	FEMALE
berb	FEMALE
berbe	FEMALE
berbel	FEMALE
berbely	FEMALE
berber	FEMALE
berbera	FEMALE
berbke	FEMALE
berbol	FEMALE
berby	FEMALE
berdie	FEMALE
berdien	FEMALE
berdina	FEMALE
berdine	FEMALE
berechja	FEMALE
berend	MALE
berend-bram	MALE
berend-jan	MALE
berendina	FEMALE
berendine	FEMALE
berengaria	FEMALE
berenice	FEMALE
berete	FEMALE
berine	FEMALE
berit	FEMALE
berita	FEMALE
berith	FEMALE
berjan	MALE
berke	MALE
berl	FEMALE
berlina	FEMALE
berlinda	FEMALE
bern	MALE
bernabent	FEMALE
bernabé	MALE
bernadet	FEMALE
bernadette	FEMALE
bernadetto	MALE
bernaldo	MALE
bernard	MALE
bernarda	FEMALE
bernarde	FEMALE
bernardino	MALE
bernardo	MALE
bernardus	MALE
bernat	MALE
bernd	MALE
bernd-henk	MALE
bernd-jan	MALE
berndt	MALE
berneen	FEMALE
bernett	FEMALE
bernett	MALE
bernhard	MALE
bernhardine	FEMALE
berni	MALE
bernice	FEMALE
bernie	MALE
bernlef	MALE
berno	MALE
bernou	FEMALE
bernulf	MALE
berny	MALE
berot	MALE
berr	MALE
berre	MALE
berrie	MALE
berry	MALE
bert	MALE
bert-jan	MALE
berta	FEMALE
berte	FEMALE
berteke	FEMALE
bertekert	FEMALE
bertel	MALE
berteld	MALE
berten	MALE
bertha	FEMALE
berthe	FEMALE
berthel	MALE
berthilde	FEMALE
berthold	MALE
berthy	FEMALE
bertie	FEMALE
bertie	MALE
bertil	MALE
bertina	FEMALE
bertine	FEMALE
bertje	FEMALE
berto	MALE
bertold	MALE
bertram	MALE
bertran	MALE
bertrand	MALE
bertrando	MALE
bertraude	FEMALE
bertri	FEMALE
bertus	MALE
bertwin	MALE
berty	FEMALE
berwout	MALE
beryl	FEMALE
bess	FEMALE
bessel	MALE
bessele	MALE
bessy	FEMALE
bete	MALE
betha	FEMALE
bethelina	FEMALE
betheline	FEMALE
betina	FEMALE
betine	FEMALE
betje	FEMALE
betse	MALE
betske	FEMALE
betta	FEMALE
bette	FEMALE
bette	MALE
bettekee	FEMALE
betti	FEMALE
bettie	FEMALE
bettina	FEMALE
bettine	FEMALE
betto	MALE
betty	FEMALE
bettysha	FEMALE
beuwe	MALE
beyonce	FEMALE
beyoncé	FEMALE
bhodi	MALE
biaggio	MALE
biagio	MALE
bianca	FEMALE
bianco	MALE
bianka	FEMALE
biauliene	FEMALE
biba	FEMALE
bibbi	FEMALE
bibi	FEMALE
bibian	FEMALE
bibianca	FEMALE
bibiane	FEMALE
bibianne	FEMALE
bibiche	FEMALE
bibienne	FEMALE
bice	FEMALE
bidelia	FEMALE
bidina	FEMALE
bieb	FEMALE
biegeltje	FEMALE
biejoya	FEMALE
bieke	FEMALE
bien	FEMALE
bien	MALE
biene	MALE
bieneke	FEMALE
bienke	MALE
biense	MALE
bient	MALE
biente	MALE
bientje	MALE
bientse	MALE
bieter	MALE
bieuwe	MALE
bieuwelien	FEMALE
bijou	FEMALE
bikkel	MALE
biko	MALE
biljana	FEMALE
bill	MALE
billie	FEMALE
billy	FEMALE
billy	MALE
bin	MALE
bina	FEMALE
binck	MALE
bincky	FEMALE
bincky	MALE
binde	MALE
bindert	MALE
bindia	FEMALE
bindiks	MALE
bindo	MALE
bindy	FEMALE
bine	FEMALE
bine	MALE
bing	MALE
binga	FEMALE
binja	FEMALE
bink	MALE
binke	MALE
binn	FEMALE
binne	MALE
binnert	MALE
binno	MALE
bino	MALE
binte	MALE
bintje	MALE
bints	MALE
bintse	MALE
bionca	FEMALE
bionda	FEMALE
birger	MALE
birgit	FEMALE
birgita	FEMALE
birgitta	FEMALE
birgitte	FEMALE
birk	MALE
birte	FEMALE
birthe	FEMALE
bisch	MALE
bix	MALE
bixenti	MALE
bjarn	MALE
bjarne	MALE
bjarni	MALE
bjenze	MALE
bjernd	MALE
bjinse	MALE
bjintse	MALE
bjintze	MALE
bjork	MALE
bjorn	MALE
bjorna	FEMALE
bjornar	MALE
björgvin	MALE
björk	FEMALE
björn	MALE
bjørn	MALE
blade	MALE
blaise	MALE
blake	MALE
blanca	FEMALE
blanche	FEMALE
blandine	FEMALE
blane	MALE
blangka	FEMALE
blanka	FEMALE
blas	MALE
blenda	FEMALE
blinne	FEMALE
blissey	FEMALE
bloeme	FEMALE
blom	FEMALE
blomme	FEMALE
blommert	MALE
blondine	FEMALE
blubje	MALE
blue	MALE
blythe	FEMALE
blánaid	FEMALE
bláth	FEMALE
bláthnat	FEMALE
bo	FEMALE
bo	MALE
bo-ann	FEMALE
bo-rachell	FEMALE
boaije	MALE
boaijen	MALE
boaike	MALE
boaitse	MALE
boaitsen	MALE
boale	MALE
boareld	MALE
boas	MALE
boatte	MALE
boaz	MALE
bob	MALE
bob-jan	MALE
bobak	MALE
bobbi	FEMALE
bobbi-lee	FEMALE
bobby	MALE
bobente	FEMALE
bobien	FEMALE
bobine	FEMALE
bode	MALE
bodessa	FEMALE
bodhi	MALE
bodhy	FEMALE
bodhy	MALE
bodil	FEMALE
bodille	FEMALE
bodine	FEMALE
bodo	MALE
body	MALE
boede	MALE
boeke	MALE
boele	MALE
boene	MALE
boet	MALE
boetie	FEMALE
bogi	MALE
boje	MALE
bojenna	FEMALE
bojoura	FEMALE
boke	MALE
bokke	MALE
bokko	MALE
bon	FEMALE
bonaria	FEMALE
bonaventura	FEMALE
bondia	FEMALE
bonita	FEMALE
bonna	FEMALE
bonneke	FEMALE
bonnie	FEMALE
bonny	FEMALE
bono	MALE
bonsen	MALE
bonte	MALE
bontje	MALE
bontke	MALE
bontko	MALE
bontsje	MALE
booie	MALE
booike	FEMALE
bootje	FEMALE
booy	MALE
boran	MALE
borchard	MALE
boreas	MALE
borg	FEMALE
borgert	MALE
borghild	FEMALE
borintha	FEMALE
boris	MALE
borislaw	MALE
borja	MALE
borka	FEMALE
borke	MALE
born	MALE
borren	MALE
borrit	MALE
borry	FEMALE
bosco	MALE
bosse	MALE
bothe	MALE
botje	MALE
botse	MALE
botte	MALE
boudeeh	MALE
boudewijn	MALE
boudie	MALE
boudine	FEMALE
bouke	MALE
bouket	FEMALE
boukje	FEMALE
bounien	FEMALE
bous	MALE
bouw	MALE
bouwe	MALE
bouwiena	FEMALE
bowen	MALE
bowi	FEMALE
bowie	MALE
bowien	FEMALE
bowine	FEMALE
boy	MALE
boyan	MALE
boyce	MALE
boyd	MALE
boye	MALE
boyke	MALE
brad	MALE
bradley	MALE
braelt	MALE
brahim	MALE
brain	MALE
brais	MALE
bralt	MALE
bram	MALE
brammert	MALE
branca	FEMALE
branco	MALE
brand	MALE
branda	FEMALE
branden	MALE
brandi	FEMALE
brandon	MALE
branka	FEMALE
branko	MALE
brantsje	MALE
brar	MALE
bras	MALE
brasil	MALE
bratt	MALE
bratte	MALE
braulio	MALE
brayn	MALE
breanna	FEMALE
breanne	FEMALE
breccnat	FEMALE
brechje	FEMALE
brecht	MALE
brechtje	FEMALE
breeda	FEMALE
bregje	FEMALE
bregtje	FEMALE
brenco	MALE
brend	MALE
brenda	FEMALE
brendan	MALE
brenden	MALE
brenna	FEMALE
brent	MALE
brenthe	FEMALE
brenwin	MALE
brett	FEMALE
brett	MALE
breun	MALE
breunetta	FEMALE
breyten	MALE
brian	MALE
briana	FEMALE
brianne	FEMALE
brice	MALE
bridey	FEMALE
bridget	FEMALE
bridney	FEMALE
brien	FEMALE
briget	FEMALE
briggitte	FEMALE
brighid	FEMALE
bright	MALE
brighten	MALE
brighton	MALE
brigida	FEMALE
brigit	FEMALE
brigita	FEMALE
brigitta	FEMALE
brigitte	FEMALE
brigyth	FEMALE
brih	FEMALE
brillo	MALE
brim	FEMALE
brim	MALE
brinio	MALE
brinn	FEMALE
briony	FEMALE
brisa	FEMALE
brisca	FEMALE
briseïs	FEMALE
briska	FEMALE
brita	FEMALE
britney	FEMALE
britt	FEMALE
britta	FEMALE
brittanie	FEMALE
brittany	FEMALE
britte	FEMALE
brittney	FEMALE
briuinseach	FEMALE
broar	MALE
brocht	MALE
broder	MALE
broderick	MALE
brody	MALE
broen	MALE
broer	MALE
broes	MALE
brogio	MALE
brona	FEMALE
bronek	MALE
bronger	MALE
bronke	FEMALE
bronne	MALE
bronneck	MALE
bronno	MALE
bront	MALE
bronte	MALE
bronwen	FEMALE
brooke	FEMALE
brooklyn	MALE
broor	MALE
bror	MALE
brord	MALE
bruce	MALE
brucht	MALE
bruford	MALE
brugt	MALE
bruining	MALE
bruintje	FEMALE
brun	MALE
bruna	FEMALE
brune	MALE
brunella	FEMALE
brunhild	FEMALE
brunhilda	FEMALE
brunhilde	FEMALE
bruni	FEMALE
brunke	MALE
bruno	MALE
bruno-hendrik	MALE
brunone	MALE
brunsje	MALE
brunt	MALE
brusje	FEMALE
brusje	MALE
brussel	FEMALE
brutil	MALE
brutus	MALE
bruun	FEMALE
bryan	MALE
bryce	MALE
brynhild	FEMALE
brynja	FEMALE
brynjar	MALE
brynn	MALE
bríd	FEMALE
brígh	FEMALE
buanann	FEMALE
bubba	MALE
buchanan	MALE
buck	MALE
buco	MALE
bud	MALE
budde	MALE
buddy	MALE
buffy	FEMALE
buijs	MALE
buitsen	MALE
buke	MALE
bumbie	FEMALE
bune	MALE
bunna	FEMALE
bunne	MALE
bunno	MALE
buntsje	MALE
burchart	MALE
burcin	FEMALE
burgje	FEMALE
burhan	MALE
burl	MALE
burny	MALE
burre	MALE
burrit	MALE
burt	MALE
burton	MALE
busby	MALE
buse	FEMALE
butcher	MALE
butros	MALE
butte	MALE
bwee	FEMALE
byne	FEMALE
byron	MALE
báine	FEMALE
bártolo	MALE
bâsgher	MALE
bärbel	FEMALE
bé	MALE
béibhinn	FEMALE
béla	MALE
bélanna	FEMALE
bóinn	FEMALE
cacharel	FEMALE
cady	FEMALE
caecilia	FEMALE
caecilius	MALE
caelestis	MALE
caeley	FEMALE
caesar	MALE
caesarian	FEMALE
caesarian	MALE
caeser	MALE
caglar	MALE
cahrin	FEMALE
caia	FEMALE
cailin	FEMALE
cailloncé	FEMALE
cain	MALE
cainnear	FEMALE
cainnech	FEMALE
cainnleach	FEMALE
caio	MALE
caireach	FEMALE
caireann	FEMALE
cairo	MALE
cairrean	FEMALE
caisar	MALE
caiser	MALE
caitlin	FEMALE
caitlyn	FEMALE
caitriona	FEMALE
caja	FEMALE
cajus	MALE
cal	MALE
calain	MALE
caleb	MALE
calictus	MALE
calinda	FEMALE
caline	FEMALE
calista	FEMALE
callan	FEMALE
callas	FEMALE
callista	FEMALE
callum	MALE
calvantra	FEMALE
calvin	MALE
camdona	FEMALE
cameron	MALE
camiel	MALE
camilla	FEMALE
camille	FEMALE
camille	MALE
camillo	MALE
camillus	MALE
camilo	MALE
cammy	MALE
campo	MALE
can	MALE
canan	FEMALE
canay	FEMALE
candace	FEMALE
candan	FEMALE
candee	FEMALE
candellaria	FEMALE
candice	FEMALE
candida	FEMALE
candido	MALE
candy	FEMALE
cane	MALE
canelia	FEMALE
canim	FEMALE
canim	MALE
canisia	FEMALE
canisius	MALE
canity	FEMALE
cannell	FEMALE
canstanze	FEMALE
cantor	MALE
caoilinn	FEMALE
caoimseach	FEMALE
caointiarn	FEMALE
caomhnait	FEMALE
caomhog	FEMALE
cara	FEMALE
caran	FEMALE
card	MALE
cardozo	MALE
carel	MALE
caress	FEMALE
caressa	FEMALE
caresse	FEMALE
caria	FEMALE
carianne	FEMALE
caridad	FEMALE
carie	FEMALE
carien	FEMALE
cariena	FEMALE
carijn	FEMALE
carima	FEMALE
carin	FEMALE
carina	FEMALE
carine	FEMALE
carissa	FEMALE
carl	MALE
carl-heinz	MALE
carl-peter	MALE
carla	FEMALE
carlanne	FEMALE
carleen	FEMALE
carli	FEMALE
carlie	FEMALE
carlien	FEMALE
carliho	MALE
carlijn	FEMALE
carlijne	FEMALE
carlinde	FEMALE
carlitos	MALE
carlo	MALE
carlos	MALE
carlota	FEMALE
carlotta	FEMALE
carlton	MALE
carluccio	MALE
carly	FEMALE
carlyn	MALE
carma	FEMALE
carmeila	FEMALE
carmel	FEMALE
carmela	FEMALE
carmelia	FEMALE
carmelinda	FEMALE
carmelita	FEMALE
carmen	FEMALE
carmijn	FEMALE
carmina	FEMALE
carmona	FEMALE
caro	FEMALE
caro-lynn	FEMALE
caroelien	FEMALE
carol	FEMALE
carol	MALE
carola	FEMALE
carole	FEMALE
carolien	FEMALE
caroliene	FEMALE
carolijncarolin	FEMALE
carolina	FEMALE
caroline	FEMALE
carolus	MALE
carolyn	FEMALE
carolyne	FEMALE
caron	FEMALE
carradin	MALE
carreen	FEMALE
carrie	FEMALE
carrin	FEMALE
carroll	FEMALE
carry	FEMALE
carsi	MALE
carst	MALE
carsten	MALE
carucha	FEMALE
carvalio	MALE
cary	MALE
caryl	MALE
cas	MALE
casciano	MALE
casey	FEMALE
cash	MALE
casimir	MALE
casimiro	MALE
caspar	MALE
casper	MALE
casra	FEMALE
cass	MALE
cassandra	FEMALE
cassidy	FEMALE
cassie	FEMALE
cassius	MALE
castor	MALE
castro	MALE
cat	FEMALE
catalijne	FEMALE
catalina	FEMALE
catalyne	FEMALE
catarina	FEMALE
catelijne	FEMALE
caterina	FEMALE
cathach	FEMALE
cathalijne	FEMALE
cathalina	FEMALE
cathareena	FEMALE
catharina	FEMALE
catharine	FEMALE
catharinus	MALE
cathelean	FEMALE
cathelijn	FEMALE
cathelijne	FEMALE
catherin	FEMALE
catherina	FEMALE
catherine	FEMALE
cathinca	FEMALE
cathleen	FEMALE
cathrien	FEMALE
cathrin	FEMALE
cathy	FEMALE
catja	FEMALE
cato	FEMALE
catootje	FEMALE
catrien	FEMALE
catriene	FEMALE
catrineke	FEMALE
catrinus	MALE
catriona	FEMALE
catuja	FEMALE
cavalho	MALE
cay	MALE
caya	FEMALE
cayenne	FEMALE
cayetano	MALE
caylee	FEMALE
cayleigh	FEMALE
caylin	FEMALE
cayusse	FEMALE
ceallach	FEMALE
ceallsach	FEMALE
cean	MALE
ceana	FEMALE
ceara	FEMALE
ceasar	MALE
cecca	FEMALE
cecco	MALE
ceciel	FEMALE
ceciele	FEMALE
cecil	MALE
cecile	FEMALE
cecilia	FEMALE
cecilie	FEMALE
cedo	MALE
cedric	MALE
cedrine	FEMALE
ceel	MALE
cees	MALE
ceibhionn	FEMALE
cel	MALE
celano	MALE
celeke	FEMALE
celest	FEMALE
celesta	FEMALE
celeste	FEMALE
celestena	FEMALE
celestien	FEMALE
celestine	FEMALE
celesto	MALE
celia	FEMALE
celie	FEMALE
celina	FEMALE
celine	FEMALE
cellest	FEMALE
cellina	FEMALE
celso	MALE
cem	MALE
cemal	MALE
cencio	MALE
cengiz	MALE
cenk	MALE
cennet	FEMALE
centaine	FEMALE
cente	MALE
cera	FEMALE
cerdic	MALE
ceremco	MALE
ceren	MALE
ceres	FEMALE
ceress	FEMALE
ceri	FEMALE
ceriel	MALE
ceril	FEMALE
cerise	FEMALE
cesar	MALE
cesare	MALE
cessair	FEMALE
ceylan	MALE
cezar	MALE
chaaniqua	FEMALE
chabeli	FEMALE
chabella	FEMALE
chad	MALE
chadia	FEMALE
chadon	MALE
chadé	FEMALE
chago	MALE
chahid	MALE
chaia	FEMALE
chaim	MALE
chaimea	FEMALE
chainechakra	FEMALE
chakil	MALE
chakir	MALE
chalaca	FEMALE
chalance	FEMALE
chalayne	FEMALE
chaline	FEMALE
chamayne	FEMALE
chambica	FEMALE
chamo	MALE
chana	FEMALE
chanan	MALE
chanas	FEMALE
chance	MALE
chancé	FEMALE
chander	MALE
chanderiela	FEMALE
chandler	MALE
chanel	FEMALE
chanella	FEMALE
chanelle	FEMALE
chanice	FEMALE
chanienke	FEMALE
chanika	FEMALE
channa	FEMALE
channah	FEMALE
channet	FEMALE
chano	MALE
chanoah	FEMALE
chanoe	FEMALE
chanoey	MALE
chansy	FEMALE
chantal	FEMALE
chantalle	FEMALE
chantany	FEMALE
chantel	FEMALE
chantell	FEMALE
chanti	FEMALE
chanty	FEMALE
chanylle	FEMALE
chané	FEMALE
chao	FEMALE
charda	FEMALE
chardonnay	FEMALE
charel	MALE
charell	FEMALE
charelle	FEMALE
chareltson	MALE
charessa	FEMALE
charetti	FEMALE
charief	MALE
charif	MALE
charilna	FEMALE
charina	FEMALE
charis	FEMALE
charisa	FEMALE
charisma	FEMALE
charissa	FEMALE
charisse	FEMALE
charista	FEMALE
charita	FEMALE
charity	FEMALE
charl	MALE
charlaine	FEMALE
charleigh	FEMALE
charlene	FEMALE
charles	MALE
charles-eduard	MALE
charles-henri	MALE
charley	MALE
charlie	MALE
charline	FEMALE
charlize	FEMALE
charlot	FEMALE
charlotta	FEMALE
charlotte	FEMALE
charlton	MALE
charly	FEMALE
charlynn	FEMALE
charmaine	FEMALE
charmen	FEMALE
charmilla	FEMALE
charo	MALE
charon	FEMALE
charonne	FEMALE
charoon	MALE
chase	MALE
chastity	FEMALE
chava	FEMALE
chavelli	FEMALE
chavon	FEMALE
chaya	FEMALE
chayanne	MALE
chayenna	FEMALE
chayenne	FEMALE
chaylin	MALE
chaymée	FEMALE
chazmay	FEMALE
chazz	MALE
che	MALE
cheana	FEMALE
chebi	FEMALE
chedé	FEMALE
chef	MALE
chelana	FEMALE
cheldy	FEMALE
chelina	FEMALE
cheline	FEMALE
chella	FEMALE
chelsea	FEMALE
chelsey	FEMALE
chelsie	FEMALE
chelyn	FEMALE
chemène	FEMALE
chenaira	FEMALE
chendo	MALE
chenille	FEMALE
chenna	FEMALE
chenoa	FEMALE
chenoah	FEMALE
chequela	FEMALE
cher	FEMALE
cheralda	FEMALE
cheralde	FEMALE
cheralo	MALE
cheraly	FEMALE
cheran	FEMALE
cheran	MALE
cherees	FEMALE
chereliecherelity	FEMALE
cherelle	FEMALE
cheretti	FEMALE
cherice	FEMALE
cherie	FEMALE
cherille	FEMALE
cherilyn	FEMALE
cherique	FEMALE
cherise	FEMALE
cherish	FEMALE
cherissa	FEMALE
cherive	FEMALE
chermaine	FEMALE
chermene	FEMALE
cheron	FEMALE
cherrisch	FEMALE
cherry	FEMALE
cheryl	FEMALE
chesco	MALE
chesney	MALE
chesro	MALE
chessel	MALE
chester	MALE
chestiny	FEMALE
chestity	FEMALE
chet	MALE
chetto	MALE
chettry	FEMALE
chevy	MALE
cheyenne	FEMALE
chiara	FEMALE
chiara	FEMALE
chiaro	MALE
chiavenna	FEMALE
chica	FEMALE
chicane	FEMALE
chiccho	MALE
chico	MALE
chiel	MALE
chiela	FEMALE
chielian	MALE
chieljan	MALE
chiem	MALE
childéric	MALE
chimene	FEMALE
chimené	FEMALE
chimène	FEMALE
chindra	FEMALE
ching	MALE
chinou	FEMALE
chinouk	FEMALE
chioris	MALE
chip	MALE
chiquita	FEMALE
chiquita	FEMALE
chislaine	FEMALE
chitra	FEMALE
chjabien	FEMALE
chlarimonda	FEMALE
chlarimonde	FEMALE
chloe	FEMALE
chlorinde	FEMALE
chloris	FEMALE
chlothilde	FEMALE
chloé	FEMALE
chloë	FEMALE
chofni	MALE
choura	FEMALE
chretienne	FEMALE
chriet	MALE
chris	FEMALE
chris	MALE
chris-paul	MALE
chrisje	FEMALE
chrisjon	MALE
chrissy	FEMALE
christ	MALE
christa	FEMALE
christabel	FEMALE
christan	MALE
christel	FEMALE
christiaan	MALE
christian	FEMALE
christian	MALE
christiana	FEMALE
christiane	FEMALE
christianna	FEMALE
christiano	MALE
christien	FEMALE
christina	FEMALE
christine	FEMALE
christiona	FEMALE
christo	MALE
christof	MALE
christoff	MALE
christoffel	MALE
christoffer	MALE
christofoor	MALE
christoforo	MALE
christoforus	MALE
christoph	MALE
christophe	MALE
christopher	MALE
christy	FEMALE
christó	MALE
christóbal	MALE
chrit	MALE
chryseïs	FEMALE
chrysothemis	FEMALE
chrystal	FEMALE
chrétien	MALE
chudesca	FEMALE
chunca	FEMALE
chunka	FEMALE
chyara	FEMALE
chyra	FEMALE
cian	MALE
ciana	FEMALE
ciannait	FEMALE
ciar	FEMALE
ciara	FEMALE
ciarnait	FEMALE
cicilia	FEMALE
ciel	FEMALE
ciel	MALE
ciet	FEMALE
cilia	FEMALE
cilla	FEMALE
cilly	FEMALE
cilou	FEMALE
cinda	FEMALE
cindel	FEMALE
cindie	FEMALE
cindy	FEMALE
cinka	FEMALE
cinta	FEMALE
cintha	FEMALE
cinthia	FEMALE
cinthy	FEMALE
cinzia	FEMALE
ciola	FEMALE
cip	MALE
cira	FEMALE
circe	FEMALE
cirilo	MALE
cirino	MALE
cirsten	FEMALE
cis	MALE
ciscisca	FEMALE
cisco	MALE
ciska	FEMALE
ciske	MALE
cisse	MALE
cissie	FEMALE
cissy	FEMALE
cita	FEMALE
cj	MALE
claartje	FEMALE
claas	MALE
claasje	FEMALE
claes	MALE
clair	FEMALE
claire	FEMALE
clairette	FEMALE
clairy	FEMALE
clar	FEMALE
clara	FEMALE
clara sue	FEMALE
clarck	MALE
clare	FEMALE
clarice	FEMALE
clarice	MALE
clarien	FEMALE
clarimond	FEMALE
clarimonda	FEMALE
clarimonde	FEMALE
clarina	FEMALE
clarinda	FEMALE
clarinde	FEMALE
clarine	FEMALE
clariska	FEMALE
clarissa	FEMALE
clarisse	FEMALE
clarita	FEMALE
clark	MALE
clarke	MALE
clasina	FEMALE
clasine	FEMALE
claude	MALE
claudette	FEMALE
claudia	FEMALE
claudien	FEMALE
claudina	FEMALE
claudine	FEMALE
claudio	MALE
claudius	MALE
claudy	FEMALE
claus	MALE
claus-jürgen	MALE
clavie	FEMALE
clay	MALE
clayton	MALE
clazien	FEMALE
clazina	FEMALE
cleavon	MALE
clem	MALE
clemence	FEMALE
clemens	MALE
clemense	FEMALE
clement	MALE
clementia	FEMALE
clementientje	FEMALE
clementina	FEMALE
clementine	FEMALE
clemme	MALE
clemmy	FEMALE
clemsey	MALE
cleo	FEMALE
cleodien	FEMALE
cleodore	FEMALE
clessian	MALE
clidna	FEMALE
clif	MALE
cliff	MALE
clifford	MALE
clifton	MALE
clim	FEMALE
climmy	FEMALE
clint	MALE
clinton	MALE
clio	FEMALE
clioh	FEMALE
cliona	FEMALE
clive	MALE
clodagh	FEMALE
clodia	FEMALE
cloe	FEMALE
clophaz	MALE
clora	FEMALE
clothilda	FEMALE
clothilde	FEMALE
clothra	FEMALE
clotilda	FEMALE
clotilde	FEMALE
clovis	MALE
cloë	FEMALE
clyde	MALE
cléo	FEMALE
co	FEMALE
co	MALE
cobi	MALE
cobie	FEMALE
coby	FEMALE
coca	FEMALE
cochrann	FEMALE
cock	FEMALE
cock	MALE
cocky	FEMALE
coco	FEMALE
cody	MALE
coen	MALE
coenraad	MALE
coera	FEMALE
coert	MALE
coin	MALE
cok	FEMALE
cok	MALE
cokky	FEMALE
cola	MALE
colas	MALE
cole	MALE
colet	FEMALE
coleta	FEMALE
coletta	FEMALE
colette	FEMALE
colien	FEMALE
colin	MALE
colinda	FEMALE
coline	FEMALE
colla	MALE
collas	MALE
collin	MALE
colm	MALE
colombanus	MALE
colombe	FEMALE
colombine	FEMALE
colum	MALE
columba	FEMALE
colón	MALE
commer	MALE
comnait	FEMALE
conall	MALE
conan	MALE
conar	MALE
concepción	FEMALE
concetine	FEMALE
concetta	FEMALE
concha	FEMALE
conchita	FEMALE
conchobarre	FEMALE
congalie	FEMALE
conita	FEMALE
conna	FEMALE
conner	MALE
conni	FEMALE
connieconny	FEMALE
connor	MALE
conor	MALE
conrad	MALE
conrad-jan	MALE
conrada	FEMALE
conradina	FEMALE
conradine	FEMALE
conradino	MALE
consolata	FEMALE
constance	FEMALE
constancia	FEMALE
constans	MALE
constant	MALE
constantijn	MALE
constantin	MALE
constantino	MALE
constantius	MALE
constantyn	MALE
constanze	FEMALE
consuelo	FEMALE
cookie	MALE
cooper	MALE
coos	MALE
coosje	FEMALE
cootje	FEMALE
cop	MALE
cor	MALE
cora	FEMALE
corald	MALE
coralie	FEMALE
coralina	FEMALE
corbach	FEMALE
corben	MALE
corbin	MALE
corbnait	FEMALE
corcair	FEMALE
cordela	FEMALE
cordelia	FEMALE
corduia	FEMALE
corduie	FEMALE
cordula	FEMALE
corella	FEMALE
corentin	MALE
coretta	FEMALE
corette	FEMALE
corianne	FEMALE
corieke	FEMALE
corien	FEMALE
coriene	FEMALE
corijn	MALE
corina	FEMALE
corinda	FEMALE
corine	FEMALE
coringe	FEMALE
corinna	FEMALE
corinne	FEMALE
coriske	FEMALE
corlien	FEMALE
corlieske	FEMALE
corlinda	FEMALE
corline	FEMALE
cormac	MALE
cornald	MALE
corne	MALE
cornee	MALE
corneel	MALE
corneille	MALE
cornel	MALE
cornelia	FEMALE
cornelie	FEMALE
cornelieke	FEMALE
cornelis	MALE
cornelise	FEMALE
corneliske	FEMALE
corneliu	MALE
cornelius	MALE
cornely	FEMALE
corney	FEMALE
corné	MALE
cornéé	MALE
corona	FEMALE
corrado	MALE
corrie	FEMALE
corrien	FEMALE
corry	FEMALE
corré	MALE
cors	MALE
corstiaan	MALE
cortino	MALE
cortney	FEMALE
corwin	MALE
cosima	FEMALE
cosimo	MALE
cosma	FEMALE
cosma	MALE
cosmar	MALE
cosmo	MALE
costiaan	MALE
costijn	MALE
courtland	MALE
courtney	FEMALE
crachelle	FEMALE
craig	MALE
cranait	FEMALE
craobhnait	FEMALE
creas	FEMALE
cred	FEMALE
crescens	MALE
creten	FEMALE
crijn	MALE
crijntje	FEMALE
crinoc	FEMALE
cris	MALE
crisja	FEMALE
crispijn	MALE
crissy	FEMALE
crista	FEMALE
cristel	FEMALE
cristiano	MALE
cristine	FEMALE
cristo	MALE
crit	MALE
crochnait	FEMALE
cron	FEMALE
cronsech	FEMALE
cruimseach	FEMALE
crystal	FEMALE
crétienne	FEMALE
csecsa	FEMALE
cuach	FEMALE
cuachnait	FEMALE
cuman	FEMALE
cumman	FEMALE
cunera	FEMALE
cuno	MALE
curchach	FEMALE
curd	MALE
curro	MALE
cwinta	FEMALE
cy	MALE
cyanne	FEMALE
cydney	FEMALE
cyenna	FEMALE
cylene	FEMALE
cylke	FEMALE
cylysce	FEMALE
cynta	FEMALE
cynthia	FEMALE
cyp	MALE
cypriaan	MALE
cyprian	MALE
cyprien	MALE
cyprus	MALE
cyrano	MALE
cyrelle	FEMALE
cyriel	MALE
cyril	MALE
cyrill	MALE
cyrille	FEMALE
cyrille	MALE
cyrillus	MALE
cyrina	FEMALE
cyrus	MALE
cyta	FEMALE
céderic	MALE
céline	FEMALE
daaf	MALE
daan	MALE
daantje	MALE
daauw	MALE
daauwe	MALE
dabbert	MALE
dabert	MALE
dabiek	MALE
daco	MALE
dadin	MALE
daem	MALE
daerd	MALE
dag	MALE
dagobert	MALE
dahlan	MALE
daidalos	MALE
daiderd	MALE
daiderk	MALE
dailey	MALE
daimen	MALE
daimi	MALE
daisid	MALE
daiver	MALE
dajo	MALE
dale	MALE
dallas	MALE
damai	MALE
damas	MALE
damian	MALE
damian/demian	MALE
damiano	MALE
damien	MALE
damion	MALE
damir	MALE
damis	MALE
damon	MALE
damos	MALE
dan	MALE
dan-dirk	MALE
dana	MALE
dandy	MALE
dane	MALE
daneel	MALE
dani	MALE
danick	MALE
daniel	MALE
daniele	MALE
daniello	MALE
danillo	MALE
danilo	MALE
daninchio	MALE
danique	MALE
daniëlo	MALE
danley	MALE
dann	MALE
danni	MALE
dannie	MALE
danny	MALE
danotien	MALE
dante	MALE
dantier	MALE
danté	MALE
danyal	MALE
danyel	MALE
dao	MALE
darel	MALE
daren	MALE
darian	MALE
darie	MALE
darieck	MALE
dario	MALE
darius	MALE
dariusz	MALE
darm	MALE
darnell	MALE
darrel	MALE
darren	MALE
darrin	MALE
darryl	MALE
darwin	MALE
daryll	MALE
daryllio	MALE
daslau	MALE
dathan	MALE
datus	MALE
dauwe	MALE
dave	MALE
davey	MALE
davick	MALE
david	MALE
davide	MALE
davin	MALE
davis	MALE
davitzen	MALE
davor	MALE
davy	MALE
dawson	MALE
dax	MALE
dayan	MALE
daymen	MALE
daymiën	MALE
dayne	MALE
dean	MALE
deangelo	MALE
debian	MALE
decarlos	MALE
dechanvey	MALE
declan	MALE
dedde	MALE
deddo	MALE
deddy	MALE
dederidio	MALE
dedier	MALE
dedlof	MALE
dedmer	MALE
dee	MALE
deen	MALE
deena	MALE
deepak	MALE
dees	MALE
deeuwe	MALE
defno	MALE
deforest	MALE
degail	MALE
dejan	MALE
dekke	MALE
delan	MALE
delano	MALE
delaro	MALE
delbert	MALE
delfilio	MALE
delfin	MALE
delgado	MALE
delinyo	MALE
delivio	MALE
delroy	MALE
demarco	MALE
demario	MALE
demetrius	MALE
demi	MALE
demian	MALE
demis	MALE
demitry	MALE
demko	MALE
demkö	MALE
demodokos	MALE
dempster	MALE
demy	MALE
dene	MALE
denes	MALE
denholm	MALE
denie	MALE
deniece	MALE
denis	MALE
deniz	MALE
dennes	MALE
denni	MALE
dennis	MALE
dennison	MALE
denny	MALE
denous	MALE
deny	MALE
denys	MALE
denzel	MALE
denzell	MALE
deon	MALE
dephlin	MALE
derek	MALE
derk	MALE
derkjan	MALE
dermont	MALE
derre	MALE
derrick	MALE
derry	MALE
derwin	MALE
desepé	MALE
desi	MALE
desideer	MALE
desiderius	MALE
desley	MALE
desley-jay	MALE
desmond	MALE
desney	MALE
desteny	MALE
dethleff	MALE
dethmer	MALE
detlef	MALE
detlof	MALE
detmer	MALE
deukalioon	MALE
devano	MALE
deven	MALE
deveron	MALE
devi	MALE
devid	MALE
devin	MALE
devlin	MALE
devon	MALE
devyn	MALE
dewald	MALE
dewy	MALE
dexter	MALE
deyan	MALE
deïfobos	MALE
dhani	MALE
diablo	MALE
diallo	MALE
diam	MALE
diamantino	MALE
diaz	MALE
dick	MALE
dicky	MALE
dico	MALE
dictus	MALE
dide	MALE
dider	MALE
diderick	MALE
diderik	MALE
didier	MALE
die	MALE
dieder	MALE
diederich	MALE
diederick	MALE
diederik	MALE
diedert	MALE
diedrerik	MALE
diedrich	MALE
diedrik	MALE
diego	MALE
diek	MALE
dieko	MALE
diemer	MALE
dies	MALE
diete	MALE
dieter	MALE
dietert	MALE
dietger	MALE
dietmar	MALE
dietrich	MALE
dietwin	MALE
dieu	MALE
dieudonné	MALE
dieuke	MALE
dieuwe	MALE
dieuwer	MALE
dieuwert	MALE
digger	MALE
dignum	MALE
dignus	MALE
dijck	MALE
dik	MALE
dikke	MALE
dilaan	MALE
dilano	MALE
dilco	MALE
dillen	MALE
dima	MALE
dimar	MALE
dimer	MALE
dimert	MALE
dimitri	MALE
dimitry	MALE
dimpel	MALE
dinand	MALE
dines	MALE
dinesh	MALE
dingelom	MALE
dingeman	MALE
dinlo	MALE
dino	MALE
dio	MALE
diodati	MALE
diomedes	MALE
dion	MALE
dionisio	MALE
dionysius	MALE
dionysos	MALE
dirck	MALE
dirim	MALE
dirk	MALE
dirk-jan	MALE
dirk-pieter	MALE
dirk-willem	MALE
dirko	MALE
ditchano	MALE
diter	MALE
ditert	MALE
ditho	MALE
ditmar	MALE
ditmer	MALE
dittger	MALE
dizzy	MALE
dié	MALE
diémo	MALE
diéz	MALE
djai	MALE
djairo	MALE
djamiel	MALE
djamiro	MALE
djan	MALE
djan-beer	MALE
django	MALE
djani	MALE
djarno	MALE
djarrel	MALE
djasmin	MALE
djay	MALE
djayden	MALE
djayordy	MALE
djeckie	MALE
djeedan	MALE
djeen	MALE
djen	MALE
djenaro	MALE
djeure	MALE
djeviano	MALE
djille	MALE
djimmer	MALE
djimmert	MALE
djimmie	MALE
djimon	MALE
djoerd	MALE
djoere	MALE
djoesha	MALE
djoi	MALE
djonno	MALE
djordi	MALE
djordie	MALE
djorven	MALE
djowie	MALE
dju	MALE
djurgen	MALE
djuri	MALE
djurre	MALE
dmitri	MALE
do	MALE
doade	MALE
doado	MALE
doaije	MALE
doaijen	MALE
doaike	MALE
doaite	MALE
doaitse	MALE
doaitsen	MALE
dob	MALE
dobbe	MALE
dobbo	MALE
dobby	MALE
doc	MALE
docus	MALE
dodde	MALE
dodo	MALE
doed	MALE
doede	MALE
doedo	MALE
doeds	MALE
doeije	MALE
doeke	MALE
doekele	MALE
doekes	MALE
doekle	MALE
doeko	MALE
doen	MALE
doene	MALE
doetse	MALE
doewe	MALE
doganay	MALE
dok	MALE
dolf	MALE
dolf-jan	MALE
domara	MALE
domas	MALE
domela	MALE
domenico	MALE
domenique	MALE
domenkus	MALE
domian	MALE
domien	MALE
domingo	MALE
dominic	MALE
dominicus	MALE
dominik	MALE
dominike	MALE
dominiq	MALE
dominique	MALE
domminick	MALE
don	MALE
donaat	MALE
donal	MALE
donald	MALE
donals	MALE
donato	MALE
donatus	MALE
done	MALE
donke	MALE
donnever	MALE
donny	MALE
dono	MALE
donovan	MALE
dooran	MALE
doran	MALE
dorian	MALE
doriano	MALE
dorke	MALE
doron	MALE
dorre	MALE
dorry	MALE
dorus	MALE
dotr	MALE
dotsen	MALE
douglas	MALE
douk	MALE
doutzen	MALE
douwe	MALE
dovano	MALE
dovino	MALE
draco	MALE
drago	MALE
dragomir	MALE
drake	MALE
dre	MALE
drees	MALE
drew	MALE
drewe	MALE
drewes	MALE
drewes	MALE
driek	MALE
dries	MALE
drieuwes	MALE
dru	MALE
drys	MALE
duane	MALE
duarte	MALE
dubte	MALE
ducan	MALE
duccio	MALE
duco	MALE
duco-gerard	MALE
dudley	MALE
duert	MALE
duff	MALE
duije	MALE
duke	MALE
duko	MALE
duncan	MALE
duoke	MALE
durand	MALE
durante	MALE
durc	MALE
durk	MALE
durwin	MALE
dusan	MALE
dusko	MALE
dustin	MALE
dusty	MALE
dutmar	MALE
dutsje	MALE
duuk	MALE
duurd	MALE
dwayne	MALE
dwight	MALE
dyamel	MALE
dyan	MALE
dycqel	MALE
dylan	MALE
dylan	MALE
dylano	MALE
dyllan	MALE
dyon	MALE
dyron	MALE
dyson	MALE
dytmer	MALE
déjan	MALE
dénis	MALE
eabbe	MALE
eabe	MALE
eabele	MALE
eade	MALE
eadge	MALE
eadse	MALE
eadsge	MALE
eadsger	MALE
ealert	MALE
eame	MALE
eamon	MALE
eapke	MALE
eard	MALE
earde	MALE
eardse	MALE
eardsje	MALE
earke	MALE
earl	MALE
earryt	MALE
earten	MALE
eate	MALE
eatse	MALE
eau	MALE
eauke	MALE
eauwe	MALE
eauwen	MALE
eb	MALE
ebbe	MALE
ebbel	MALE
ebbele	MALE
ebben	MALE
ebbert	MALE
ebbie	MALE
ebbing	MALE
ebble	MALE
ebbo	MALE
ebe	MALE
ebel	MALE
ebele	MALE
eben	MALE
ebert	MALE
ebke	MALE
ebo	MALE
ebolt	MALE
ece	MALE
eckart	MALE
eckehard	MALE
eco	MALE
ed	MALE
edar-pierre	MALE
edde	MALE
eddie	MALE
eddo	MALE
eddy	MALE
ede	MALE
ede	MALE
eden	MALE
edgar	MALE
edib	MALE
edies	MALE
edius	MALE
edivaldo	MALE
edme	MALE
edmond	MALE
edmondo	MALE
edmund	MALE
edmundo	MALE
edo	MALE
edoardo	MALE
edouard	MALE
edouw	MALE
edouward	MALE
edsard	MALE
edsart	MALE
edse	MALE
edser	MALE
edsert	MALE
edsge	MALE
edsger	MALE
edsje	MALE
edske	MALE
edsko	MALE
edson	MALE
eduard	MALE
eduardo	MALE
eduardus	MALE
edvard	MALE
edvige	MALE
edward	MALE
edwer	MALE
edwin	MALE
edzard	MALE
edzard	MALE
edze	MALE
edzko	MALE
edzo	MALE
eedje	MALE
eeds	MALE
eedse	MALE
eedsge	MALE
eedsger	MALE
eedwer	MALE
eef	MALE
eeke	MALE
eelco	MALE
eelde	MALE
eeldert	MALE
eelje	MALE
eelk	MALE
eelke	MALE
eelker	MALE
eelse	MALE
eeltse	MALE
eeltsje	MALE
eelze	MALE
eembert	MALE
eemke	MALE
een	MALE
eenke	MALE
eense	MALE
eente	MALE
eento	MALE
eentsje	MALE
eerdse	MALE
eerke	MALE
eert	MALE
eesge	MALE
eetre	MALE
eetse	MALE
eeuwe	MALE
eeuwit	MALE
eeuwke	MALE
efraim	MALE
egbert	MALE
ege	MALE
egele	MALE
eger	MALE
egge	MALE
eggerik	MALE
egges	MALE
eggo	MALE
egide	MALE
egidio	MALE
egidius	MALE
egied	MALE
egizo	MALE
egle	MALE
egmond	MALE
ego	MALE
egon	MALE
egor	MALE
eibe	MALE
eibert	MALE
eid	MALE
eide	MALE
eidse	MALE
eie	MALE
eige	MALE
eije	MALE
eijen	MALE
eijpe	MALE
eike	MALE
eiko	MALE
eile	MALE
eilke	MALE
eilof	MALE
eilt	MALE
eimardo	MALE
eime	MALE
eimert	MALE
einar	MALE
einbert	MALE
eine	MALE
einke	MALE
einrikr	MALE
einse	MALE
einte	MALE
eintsje	MALE
eirik	MALE
eise	MALE
eiske	MALE
eiso	MALE
eisse	MALE
eisso	MALE
eit	MALE
eite	MALE
eitel	MALE
eitse	MALE
eitsje	MALE
eitze	MALE
eizo	MALE
eja	MALE
ejay	MALE
eke	MALE
ekke	MALE
ekker	MALE
eko	MALE
el	MALE
elano	MALE
elard	MALE
elart	MALE
elbert	MALE
elby	MALE
elck	MALE
elco	MALE
eldad	MALE
elder	MALE
eldert	MALE
eldin	MALE
eldridge	MALE
ele	MALE
elek	MALE
elert	MALE
elfred	MALE
elgar	MALE
elger	MALE
elgin	MALE
eli	MALE
elia	MALE
elian	MALE
eliano	MALE
elias	MALE
eliezer	MALE
eligius	MALE
elija	MALE
eling	MALE
elio	MALE
elion	MALE
elis	MALE
eljakim	MALE
eljosha	MALE
elkan	MALE
elke	MALE
elko	MALE
elladio	MALE
elle	MALE
ellert	MALE
ellery	MALE
ello	MALE
elmar	MALE
elmardo	MALE
elmas	MALE
elmer	MALE
elmert	MALE
elmo	MALE
elmyr	MALE
elo	MALE
elon	MALE
elonzo	MALE
elout	MALE
eloy	MALE
elprich	MALE
elroy	MALE
els	MALE
else	MALE
elsert	MALE
elst	MALE
elte	MALE
eltje	MALE
eltjo	MALE
elton	MALE
eltsje	MALE
elvin	MALE
elvio	MALE
elvis	MALE
elwin	MALE
elzard	MALE
elze	MALE
elzo	MALE
emanuel	MALE
emar	MALE
embry	MALE
eme	MALE
emek	MALE
emerentius	MALE
emerico	MALE
emerson	MALE
emiel	MALE
emil	MALE
emile	MALE
emilian	MALE
emiliano	MALE
emilio	MALE
emmanuel	MALE
emmer	MALE
emmerik	MALE
emmert	MALE
emmet	MALE
emmo	MALE
emo	MALE
emond	MALE
emrah	MALE
emre	MALE
emri	MALE
emry	MALE
emrys	MALE
en	MALE
ender	MALE
ene	MALE
enea	MALE
enes	MALE
engbert	MALE
engel	MALE
engelbert	MALE
engelbrekt	MALE
engele	MALE
engelke	MALE
engle	MALE
enio (ennio)	MALE
enjelco	MALE
enke	MALE
enne	MALE
ennio	MALE
enno	MALE
eno	MALE
enoch	MALE
enrico	MALE
enrique	MALE
ente	MALE
ento	MALE
entse	MALE
enzio	MALE
enzo	MALE
enö	MALE
ep	MALE
epe	MALE
epeos	MALE
ephram	MALE
epimetheus	MALE
epke	MALE
eppe	MALE
eppie	MALE
eppo	MALE
eran	MALE
erardo	MALE
erasmo	MALE
erasmus	MALE
eray	MALE
erben	MALE
erberto	MALE
erbst	MALE
ercolano	MALE
ercole	MALE
erdmann	MALE
erdo	MALE
erdy	MALE
erginos	MALE
erhard	MALE
eriberto	MALE
eric	MALE
erich	MALE
erick	MALE
erie	MALE
erienne	MALE
erik	MALE
erik-jan	MALE
erik-paul	MALE
eriq	MALE
erjan	MALE
erjen	MALE
erk	MALE
erkan	MALE
erkenbout	MALE
ermanno	MALE
ermanno	MALE
ermen	MALE
ermino	MALE
ermo	MALE
ernest	MALE
ernestino	MALE
ernesto	MALE
erno	MALE
ernout	MALE
ernst	MALE
ernst-jaap	MALE
ernst-paul	MALE
ernstjan	MALE
erol	MALE
eroos	MALE
eros	MALE
erre	MALE
errien	MALE
erriet	MALE
errit	MALE
errol	MALE
erryn	MALE
erryt	MALE
ersin	MALE
erskine	MALE
ert	MALE
ervin	MALE
erwan	MALE
erwin	MALE
esa-pekka	MALE
esaias	MALE
esban	MALE
esbern	MALE
esbjørn	MALE
esdert	MALE
esdran	MALE
ese	MALE
esgo	MALE
eske	MALE
esli	MALE
esmond	MALE
espen	MALE
esper	MALE
esra	MALE
esse	MALE
esso	MALE
este	MALE
esteban	MALE
esteban	MALE
esterske	MALE
estha	MALE
estévan	MALE
etam	MALE
ete	MALE
eteokles	MALE
ethan	MALE
etienne	MALE
etsen	MALE
ette	MALE
etto	MALE
ettore	MALE
etward	MALE
euan	MALE
eugene	MALE
eugenio	MALE
eugenius	MALE
euguene	MALE
eugène-gérard	MALE
eumaios	MALE
euryalos	MALE
eurymachos	MALE
eurystheus	MALE
eustachio	MALE
euwe	MALE
evald	MALE
evan	MALE
evan	MALE
evander	MALE
evaristo	MALE
evelyn	MALE
everardo	MALE
everaud	MALE
everbert	MALE
evere	MALE
everen	MALE
everett	MALE
everhard	MALE
everhardus	MALE
everly	MALE
everon	MALE
evert	MALE
evert-anthony	MALE
evert-jan	MALE
evertjan	MALE
evgeni	MALE
eviëlle	MALE
evrard	MALE
ewald eward	MALE
ewan	MALE
ewart	MALE
ewe	MALE
ewert	MALE
ewit	MALE
ewold	MALE
ewoud	MALE
ewout	MALE
ewut	MALE
exan	MALE
excaliber	MALE
eyrylochos	MALE
eyso	MALE
eyyüp	MALE
eyzo	MALE
ezeqiel	MALE
ezra	MALE
ezzo	MALE
faas	MALE
faaske	FEMALE
faber	MALE
fabia	FEMALE
fabian	MALE
fabiana	FEMALE
fabiano	MALE
fabianus	MALE
fabien	MALE
fabienne	FEMALE
fabio	MALE
fabiola	FEMALE
fabius	MALE
fabiën	MALE
fabiënne	FEMALE
fabrice	MALE
fabricia	FEMALE
fabricius	MALE
fabrienne	FEMALE
fabrizia	FEMALE
fabrizio	MALE
facco	MALE
facolien	FEMALE
fadme	FEMALE
fadoua	FEMALE
fadrique	MALE
fadyan	MALE
fae	FEMALE
faes	MALE
fagmar	FEMALE
faidimos	MALE
faife	FEMALE
failenn	FEMALE
failon	FEMALE
fainche	FEMALE
fairouz	FEMALE
faisal	MALE
faith	FEMALE
faithe	FEMALE
faithley	FEMALE
faja	FEMALE
fajah	FEMALE
fake	MALE
falco	MALE
falda	FEMALE
falk	MALE
fallon	FEMALE
fam	FEMALE
famke	FEMALE
fancy	FEMALE
fane	MALE
fang-kay	MALE
fania	FEMALE
fanie	FEMALE
fannie	FEMALE
fanny	FEMALE
fantine	FEMALE
faquita	FEMALE
fara	FEMALE
faraaz	MALE
farah	FEMALE
farahilde	FEMALE
faralda	FEMALE
fardau	FEMALE
fardo	FEMALE
fardouw	FEMALE
fares	MALE
faria	FEMALE
farida	FEMALE
faris	MALE
fariëlla	FEMALE
farley	MALE
farrel	MALE
farried	MALE
fastwin	MALE
fatih	MALE
fatima	FEMALE
fatime	FEMALE
fatma	FEMALE
fatoumata	FEMALE
faugje	FEMALE
fausia	FEMALE
fausta	FEMALE
faustina	FEMALE
faustine	FEMALE
faustino	MALE
fausto	MALE
faustus	MALE
fauve	FEMALE
fawzi	MALE
fay	FEMALE
faya	FEMALE
faye	FEMALE
fayette	MALE
faylien	FEMALE
fayoia	FEMALE
fayska	FEMALE
fazila	FEMALE
fazira	FEMALE
faëthoon	MALE
fe	MALE
fea	FEMALE
feargal	MALE
feath	FEMALE
febe	FEMALE
febri	FEMALE
fedda	FEMALE
fedde	MALE
fedderi	MALE
feddrik	MALE
feddy	MALE
fedelm	FEMALE
federica	FEMALE
federico	MALE
federiga	FEMALE
federigo	MALE
fedja	MALE
fedor	MALE
fedora	FEMALE
fedosja	FEMALE
fedrik	MALE
feduard	MALE
fee	FEMALE
feebe	FEMALE
feel	MALE
feenia	FEMALE
feico	MALE
feie	MALE
feija	FEMALE
feije	MALE
feike	FEMALE
feikje	FEMALE
feiko	MALE
feitse	MALE
fekje	FEMALE
fekke	MALE
felante	FEMALE
felda	FEMALE
feli	FEMALE
felice	FEMALE
felice	MALE
felicia	FEMALE
feliciaan	MALE
feliciana	FEMALE
feliciano	MALE
felicienne	FEMALE
felicitas	FEMALE
felicity	FEMALE
felicité	FEMALE
felien	FEMALE
feline	FEMALE
felipa	FEMALE
felipe	MALE
felipe	MALE
felis	MALE
felix	MALE
felizitas	FEMALE
felke	FEMALE
felony	FEMALE
felony	MALE
fem	FEMALE
feme	FEMALE
femi	FEMALE
femia	FEMALE
femie	FEMALE
femios	MALE
femke	FEMALE
femkje	FEMALE
femma	FEMALE
femme	MALE
femmie	FEMALE
femmieke	FEMALE
femmy	FEMALE
fen	MALE
fenelia	FEMALE
fenella	FEMALE
fenke	FEMALE
fenlina	FEMALE
fenn	FEMALE
fenna	FEMALE
fennanda	FEMALE
fenne	FEMALE
fennegien	FEMALE
fenneke	FEMALE
fennelien	FEMALE
fenno	MALE
fenny	FEMALE
fenya	FEMALE
feodoor	MALE
feodora	FEMALE
fer	MALE
fera	FEMALE
ferani	FEMALE
ferd	MALE
ferdi	MALE
ferdinand	MALE
ferdinanda	FEMALE
ferdy	MALE
fere	MALE
ferenc	MALE
ference	MALE
fergus	MALE
ferguut	MALE
feria	FEMALE
ferinand	MALE
ferjo	MALE
ferko	MALE
fermín	MALE
fern	FEMALE
fernand	MALE
fernanda	FEMALE
fernande	FEMALE
fernande	MALE
fernandez	MALE
fernandina	FEMALE
fernando	MALE
fernao	MALE
ferona	FEMALE
feronia	FEMALE
ferosh	MALE
ferran	MALE
ferrand	MALE
ferrando	MALE
ferre	MALE
ferren	MALE
ferri	MALE
ferron	MALE
ferry	MALE
fethnat	FEMALE
fetsje	FEMALE
feya	FEMALE
feye	MALE
feyo	MALE
feyona	FEMALE
fhebe	FEMALE
fia	FEMALE
fial	FEMALE
fianait	FEMALE
fianna	FEMALE
fianne	FEMALE
fico	MALE
fida	FEMALE
fideel	MALE
fideilme	FEMALE
fidelia	FEMALE
fidelio	MALE
fidelis	MALE
fidelma	FEMALE
fiducia	FEMALE
fidèle	FEMALE
fiebe	FEMALE
fieke	FEMALE
fiel	MALE
fien	FEMALE
fieneke	FEMALE
fienly	FEMALE
fientje	FEMALE
fiep	FEMALE
fietje	FEMALE
fieurance	FEMALE
fieze-gäöt	FEMALE
figen	FEMALE
figo	MALE
fijgje	FEMALE
filemon	MALE
filiberto	MALE
filine	FEMALE
filiotis	MALE
filip	MALE
filippa	FEMALE
filippine	FEMALE
filippo	MALE
filippus	MALE
filipus	MALE
filique	FEMALE
filo	MALE
filoktetes	MALE
filomeen	FEMALE
filomena	FEMALE
filou	FEMALE
fimke	FEMALE
fin	MALE
finbar	MALE
finbarr	MALE
fincent	MALE
fineke	FEMALE
finetta	FEMALE
fineus	MALE
finidi	MALE
finja	FEMALE
finlay	MALE
finley	MALE
finn	MALE
finn-christian	MALE
finnabair	FEMALE
finnchaem	FEMALE
finnchnes	FEMALE
finneacht	FEMALE
finneke	FEMALE
finnja	FEMALE
finnr	MALE
finola	FEMALE
finscoth	FEMALE
fiola	FEMALE
fion	MALE
fiona	FEMALE
fionnabhair	FEMALE
fionnait	FEMALE
fionnuala	FEMALE
fiorella	FEMALE
fiorello	MALE
fiorenza	FEMALE
fioretta	FEMALE
fiorgia	FEMALE
fiori	FEMALE
fiorina	FEMALE
firank	MALE
firdaous	FEMALE
firmijn	MALE
firmin	MALE
firminus	MALE
fita	FEMALE
fithir	FEMALE
fitz	MALE
fjilka	FEMALE
fjodor	MALE
fjodora	FEMALE
fjødr	MALE
flaminia	FEMALE
flann	FEMALE
flavia	FEMALE
flaviana	FEMALE
flaviano	MALE
flavien	MALE
flavio	MALE
flemming	MALE
fleur	FEMALE
fleure	FEMALE
fleurette	FEMALE
fleurtje	FEMALE
flidais	FEMALE
flien	FEMALE
fliep	MALE
flin	FEMALE
flint	MALE
flip	MALE
flippe	MALE
floor	FEMALE
floorke	FEMALE
floorke	MALE
floortje	FEMALE
flor	FEMALE
flor	MALE
flora	FEMALE
floran	MALE
florance	FEMALE
flore	FEMALE
florein	MALE
florence	FEMALE
florens	MALE
florent	MALE
florentia	FEMALE
florentien	FEMALE
florentin	MALE
florentine	FEMALE
florentius	MALE
florentyn	MALE
florenz	MALE
florenzia	FEMALE
flores	MALE
floretta	FEMALE
florette	FEMALE
floriaan	MALE
florian	FEMALE
florian	MALE
floriane	FEMALE
florianna	FEMALE
florianne	FEMALE
florieke	FEMALE
florien	FEMALE
florijntje	FEMALE
florijntje	MALE
florina	FEMALE
florine	FEMALE
floris	MALE
floris-lan	MALE
florisante	FEMALE
florrie	FEMALE
florry	FEMALE
floryn	MALE
flos	FEMALE
flossie	FEMALE
flower	FEMALE
floyd	MALE
fobke	FEMALE
focko	MALE
foday	MALE
fodla	FEMALE
foeke	FEMALE
foekje	FEMALE
foinix	MALE
fok	MALE
foka	FEMALE
foke	MALE
fokelina	FEMALE
fokje	FEMALE
fokke	FEMALE
fokke	MALE
fokkelien	FEMALE
fokko	MALE
folco	MALE
folie	MALE
folka	FEMALE
folke	MALE
folker	MALE
folkersje	FEMALE
folkert	MALE
folko	MALE
folkward	MALE
folly	FEMALE
folmer	MALE
folos	MALE
fonger	MALE
fonne	MALE
fonny	FEMALE
fons	MALE
fonsine	FEMALE
fonsje	FEMALE
fonske	FEMALE
fop	MALE
fopje	FEMALE
fopke	FEMALE
foppe	MALE
foran	MALE
forest	MALE
forkys	MALE
forlaith	FEMALE
formijn	MALE
forn	FEMALE
forn	MALE
forrest	MALE
fortuna	FEMALE
fortunat	FEMALE
fos	MALE
fosien	FEMALE
foske	FEMALE
foster	MALE
frair	FEMALE
fran	FEMALE
franc	MALE
franca	FEMALE
francella	FEMALE
francelle	FEMALE
frances	FEMALE
francesc	MALE
francesca	FEMALE
francesco	MALE
franceska	FEMALE
franci	FEMALE
francies	MALE
francina	FEMALE
francine	FEMALE
francis	FEMALE
francis	MALE
francisca	FEMALE
francisco	MALE
franciscus	MALE
franciska	FEMALE
francisquito	MALE
franciszka	FEMALE
franck	MALE
franco	MALE
francois	MALE
francois-henri	MALE
francois-xavier	MALE
francoise	FEMALE
francy	FEMALE
franda	FEMALE
franek	MALE
franja	FEMALE
frank	MALE
franka	FEMALE
franke	MALE
frankie	MALE
franklin	MALE
franklou	MALE
franky	FEMALE
franky	MALE
franny	FEMALE
frans	MALE
fransien	FEMALE
fransina	FEMALE
fransiska	FEMALE
fransje	FEMALE
fransje	MALE
frantisek	MALE
franz	MALE
franz-xaver	MALE
franzi	FEMALE
franziska	FEMALE
frauke	FEMALE
fraukje	FEMALE
frauwa	FEMALE
frawa	FEMALE
fre	MALE
frea	FEMALE
frebora	FEMALE
fred	MALE
freda	FEMALE
fredau	FEMALE
freddie	FEMALE
freddy	MALE
fredegonde	FEMALE
frederic	MALE
frederica	FEMALE
frederick	MALE
frederico	MALE
frederiek	FEMALE
frederieke	FEMALE
frederik	MALE
frederika	FEMALE
frederike	FEMALE
frederique	FEMALE
frederique	MALE
frederiska	FEMALE
fredine	FEMALE
fredrico	MALE
fredrik	MALE
fredrike	FEMALE
free	FEMALE
free	MALE
freeck	MALE
freek	MALE
freeke	FEMALE
freekje	FEMALE
freere	MALE
freerk	MALE
freida	FEMALE
freija	FEMALE
freke	FEMALE
frels	FEMALE
fren	MALE
frence	MALE
frences	FEMALE
frency	FEMALE
frenk	MALE
frenky	MALE
frens	MALE
frenzy	FEMALE
freukje	FEMALE
freya	FEMALE
frida	FEMALE
frido	MALE
frie	MALE
fried	MALE
frieda	FEMALE
friede	FEMALE
friedel	MALE
friederieke	FEMALE
friederika	FEMALE
friederike	FEMALE
friedje	FEMALE
friedl	FEMALE
friedlinde	FEMALE
friedrick	MALE
friedus	MALE
frigge	MALE
friso	MALE
frithjof	MALE
frithjof	MALE
fritjof	MALE
frits	MALE
frits-hein	MALE
frits-marnix	MALE
fritz	MALE
fritzi	FEMALE
fritzie	FEMALE
frixos	MALE
frode	MALE
frodo	MALE
frone	FEMALE
frouke	FEMALE
froukje	FEMALE
frouko	MALE
frouwe	FEMALE
fuat	MALE
fuijara	FEMALE
fuiko	MALE
fulbert	MALE
fulco	MALE
fulko	MALE
fulvio	MALE
funda	FEMALE
funmilayo	MALE
fushia	FEMALE
fusien	FEMALE
fuske	FEMALE
fynn	MALE
félice	FEMALE
féline	FEMALE
féliya	FEMALE
gaard	MALE
gabe	MALE
gabi	FEMALE
gabi	MALE
gabie	MALE
gabor	MALE
gabri	FEMALE
gabri	MALE
gabriel	FEMALE
gabriel	MALE
gabriela	FEMALE
gabriele	FEMALE
gabriele	MALE
gabriella	FEMALE
gabrielle	FEMALE
gabriello	MALE
gabrio	MALE
gabry	FEMALE
gaby	FEMALE
gaddo	MALE
gaetan	MALE
gaetano	MALE
gafalie	FEMALE
gahrance	FEMALE
gaia	FEMALE
gailey	FEMALE
gaily	FEMALE
galama	FEMALE
galatea	FEMALE
galateia	FEMALE
galathea	FEMALE
galdo	MALE
galeno	MALE
galiana	FEMALE
galiena	FEMALE
galina	FEMALE
galinda	FEMALE
gamala	MALE
gambia	MALE
gaminne	FEMALE
gandalf	MALE
gandert	MALE
gandolfo	MALE
gandor	MALE
ganduif	MALE
ganja	FEMALE
ganna	FEMALE
garaldino	MALE
garance	FEMALE
garcia	FEMALE
garda	FEMALE
gardina	FEMALE
garen	MALE
gareth	MALE
garina	FEMALE
garke	FEMALE
garnett	FEMALE
garret	MALE
garrnt	MALE
garrri	MALE
gart	MALE
gary	MALE
gaspare	MALE
gasparo	MALE
gasten	MALE
gastia	FEMALE
gaston	MALE
gati	MALE
gatty	FEMALE
gauke	FEMALE
gaukje	FEMALE
gauthier	MALE
gauwe	MALE
gavin	MALE
gawain	MALE
gawein	MALE
gay	FEMALE
gaya	FEMALE
gayle	FEMALE
gazy	FEMALE
gazy	MALE
gaëlle	FEMALE
gaëtan	MALE
gaëtano	MALE
ge	FEMALE
ge	MALE
gea	FEMALE
geanne	FEMALE
geatano	MALE
geatse	MALE
gebbe	FEMALE
gebbe	MALE
gebke	FEMALE
gebrielia	FEMALE
gedeon	MALE
gedo	MALE
geeke	FEMALE
geelke	FEMALE
geerdiene	FEMALE
geerdje	FEMALE
geerjanne	FEMALE
geerke	FEMALE
geerling	MALE
geerlof	MALE
geert	MALE
geert-jan	MALE
geerte	FEMALE
geerten	MALE
geertjan	MALE
geertje	FEMALE
geertrui	FEMALE
geertruida	FEMALE
geese	FEMALE
geesje	FEMALE
geeske	FEMALE
geffrey	MALE
geike	FEMALE
geirolf	MALE
geirulf	MALE
geirulv	MALE
geke	FEMALE
gelder	MALE
geldert	MALE
gele	FEMALE
gelgeis	FEMALE
gelien	FEMALE
geliene	FEMALE
gelika	FEMALE
gelina	FEMALE
gelique	FEMALE
gelkje	FEMALE
gelle	MALE
gellyon	MALE
gelmer	MALE
gelmerliena	FEMALE
gelske	FEMALE
geltruda	FEMALE
gelya	FEMALE
gemaine	FEMALE
gemma	FEMALE
genaro	MALE
gene	MALE
generino	MALE
genes	FEMALE
genesam	FEMALE
genevieve	FEMALE
genia	FEMALE
genie	FEMALE
genna	FEMALE
gennariello	MALE
gennaro	MALE
geno	MALE
genovefa	FEMALE
genoveva	FEMALE
gentia	FEMALE
gentil	MALE
gentle	FEMALE
geo	MALE
geoff	MALE
geoffanni	MALE
geoffanny	MALE
geoffrey	MALE
geofredo	MALE
georg	MALE
george	MALE
georgette	FEMALE
georgia	FEMALE
georgie	FEMALE
georgina	FEMALE
georgine	FEMALE
georginia	FEMALE
georgino	MALE
georgio	MALE
georgios	MALE
geovanni	MALE
gepje	FEMALE
gepke	FEMALE
ger	FEMALE
ger	MALE
gera	FEMALE
geraar	MALE
gerad	MALE
gerald	MALE
geralda	FEMALE
geralde	FEMALE
geraldien	FEMALE
geraldine	FEMALE
geraldo	MALE
geralinde	FEMALE
geralyn	FEMALE
geralynn	FEMALE
gerana	FEMALE
geranda	FEMALE
gerard	MALE
gerarda	FEMALE
gerardina	FEMALE
gerardo	MALE
gerbald	MALE
gerben	MALE
gerbert	MALE
gerbertje	FEMALE
gerbo	MALE
gerbrand	MALE
gerbrecht	MALE
gerbrich	MALE
gerbrig	FEMALE
gerco	MALE
gerd	MALE
gerda	FEMALE
gerde	FEMALE
gerdi	FEMALE
gerdie	FEMALE
gerdien	FEMALE
gerdienke	FEMALE
gerdina	FEMALE
gerdine	FEMALE
gerdita	FEMALE
gerdjan	MALE
gerdje	FEMALE
gerdo	MALE
gerdwin	MALE
gerdy	FEMALE
gereke	FEMALE
gereldine	FEMALE
geremia	MALE
geretta	FEMALE
gerfien	MALE
gerhald	MALE
gerhard	MALE
gerharda	FEMALE
gerhardus	MALE
geri	FEMALE
geri	MALE
gerian	MALE
gerianne	FEMALE
gerietha	FEMALE
geriette	FEMALE
gerike	FEMALE
gerinde	FEMALE
gerita	FEMALE
gerjan	MALE
gerjanne	FEMALE
gerjanneke	FEMALE
gerjo	MALE
gerjon	MALE
gerke	FEMALE
gerkje	FEMALE
gerko	MALE
gerlach	MALE
gerlacia	FEMALE
gerlanda	FEMALE
gerleen	FEMALE
gerlene	FEMALE
gerlie	FEMALE
gerliene	FEMALE
gerlind	FEMALE
gerlinda	FEMALE
gerlinde	FEMALE
gerlindis	FEMALE
gerlissa	FEMALE
gerlo	MALE
gerlof	MALE
germ	MALE
germaine	FEMALE
german	MALE
germana	FEMALE
gernald	MALE
gernel	FEMALE
gero	MALE
gerold	MALE
gerolf	MALE
gerolt	MALE
geromian	MALE
geronima	FEMALE
geronimo	MALE
gerralda	FEMALE
gerran	MALE
gerredina	FEMALE
gerreit	MALE
gerrianne	FEMALE
gerrie	FEMALE
gerrie	MALE
gerrienke	FEMALE
gerriet	FEMALE
gerrit	MALE
gerritjan	MALE
gerritje	FEMALE
gerrtraud	FEMALE
gerry	FEMALE
gerry	MALE
gerson	MALE
gersón	MALE
gert	MALE
gert jan	MALE
gert wim	MALE
gert-aldert	MALE
gert-jan	MALE
gerta	FEMALE
gerti	FEMALE
gertia	FEMALE
gertie	FEMALE
gertjan	MALE
gertje	FEMALE
gerton	MALE
gertraude	FEMALE
gertraut	FEMALE
gertrud	FEMALE
gertruda	FEMALE
gertrude	FEMALE
gertrudis	FEMALE
gertruida	FEMALE
gertruud	FEMALE
gerty	FEMALE
gervaas	MALE
gervaise	FEMALE
gervan	MALE
gerwald	MALE
gerwilmer	MALE
gerwim	MALE
gerwin	MALE
geryones	MALE
gescha	FEMALE
getse	MALE
getsje	FEMALE
getske	FEMALE
gettij	FEMALE
geurt	MALE
gewieke	FEMALE
geza	MALE
gezelia	FEMALE
gezina	FEMALE
gezinneke	FEMALE
ghassen	MALE
ghilaine	FEMALE
ghino	MALE
ghislain	MALE
ghislaine	FEMALE
ghisleen	FEMALE
ghylain	MALE
ghylene	FEMALE
giacinta	FEMALE
giacinto	MALE
giacobbe	MALE
giacomo	MALE
giadella	FEMALE
giambattista	MALE
giampiero	MALE
gian	MALE
gian-luca	MALE
giancarlo	MALE
gianfranco	MALE
gianluca	MALE
gianmarco	MALE
gianna	FEMALE
gianne	FEMALE
gianni	MALE
giannina	FEMALE
gib	MALE
gibbo	MALE
gida	FEMALE
gidde	MALE
gideon	MALE
gidi	MALE
gidio	MALE
gidion	MALE
gido	MALE
gidon	MALE
giede	MALE
giel	MALE
gieles	MALE
gielian	MALE
gielke	FEMALE
giem	MALE
giene	FEMALE
gieneke	FEMALE
gienus	MALE
giep	FEMALE
giete	FEMALE
gigi	FEMALE
gigi	MALE
gijs	MALE
gijsbert	MALE
gijsbertus	MALE
gijsbrecht	MALE
gijsje	FEMALE
gijsje	MALE
gil	FEMALE
gil	MALE
gilanni	MALE
gilanno	MALE
gilbert	MALE
gilberto	MALE
gilby	MALE
gilda	FEMALE
gileine	FEMALE
giliam	MALE
gilian	MALE
giljom	MALE
gilke	FEMALE
gill	FEMALE
gilla	FEMALE
gilles	MALE
gillian	MALE
gillion	MALE
gillis	MALE
gilly	FEMALE
gilmoora	FEMALE
gilmore	MALE
gilou	FEMALE
gilsi	MALE
gina	FEMALE
ginaldion	MALE
ginamarie	FEMALE
ginebra	FEMALE
gineke	FEMALE
ginette	FEMALE
ginevra	FEMALE
ginger	FEMALE
gino	MALE
gintare	FEMALE
ginuwina	FEMALE
giny	FEMALE
gio	MALE
gioachino	MALE
giocobbe	MALE
gioconda	FEMALE
giona	FEMALE
giona	MALE
gionna	FEMALE
giordano	MALE
giorginhio	MALE
giorgino	MALE
giorgio	MALE
giorgos	MALE
giovan	MALE
giovanie	MALE
giovanna	FEMALE
giovanni	MALE
giovannino	MALE
giraldo	MALE
girbe	MALE
girolamo	MALE
gisa	FEMALE
gisbert	MALE
giscard	MALE
gisela	FEMALE
gisele	FEMALE
giselia	FEMALE
giselie	FEMALE
gisella	FEMALE
giselle	FEMALE
gisienus	MALE
gislaine	FEMALE
gislainne	FEMALE
gismonda	FEMALE
gismondo	MALE
gita	FEMALE
githa	FEMALE
githe	FEMALE
gitt	FEMALE
gitta	FEMALE
gittan	FEMALE
gitte	FEMALE
gittje	FEMALE
gitty	FEMALE
giuletta	FEMALE
giulia	FEMALE
giuliana	FEMALE
giuliano	MALE
giulietta	FEMALE
giulio	MALE
giuseppa	FEMALE
giuseppe	MALE
giuseppina	FEMALE
giuseppino	MALE
giustina	FEMALE
giustino	MALE
giusto	MALE
givan	MALE
givano	MALE
givenny	FEMALE
givin	MALE
gizem	FEMALE
gjalt	MALE
gjerulf	MALE
gladys	FEMALE
glauke	FEMALE
glaukos	MALE
glen	MALE
glenda	FEMALE
glenn	FEMALE
glenn	MALE
gless	MALE
glijn	MALE
glinis	FEMALE
gloria	FEMALE
gloriana	FEMALE
glorify	FEMALE
gloriosa	FEMALE
goan	MALE
gobinet	FEMALE
gobnait	FEMALE
godard	MALE
godele	FEMALE
godelief	FEMALE
godelieve	FEMALE
godert	MALE
godevaart	MALE
godfrey	MALE
godfried	MALE
godhard	MALE
godiva	FEMALE
godlef	MALE
godofredo	MALE
godwin	MALE
goede	MALE
goedeie	FEMALE
goedele	FEMALE
goeran	MALE
goes	FEMALE
goesje	FEMALE
goesta	MALE
goffe	MALE
goffredo	MALE
gofredo	MALE
gohan	MALE
golda	FEMALE
goldwyn	MALE
gomar	MALE
gomarus	MALE
gonda	FEMALE
goni	MALE
gonne	FEMALE
gonneke	FEMALE
gonnie	FEMALE
gonny	FEMALE
gonzalo	MALE
goof	MALE
gooitzen	MALE
gool	MALE
goos	MALE
goossen	MALE
gooszen	MALE
goran	MALE
gordana	FEMALE
gordon	MALE
gorik	MALE
goris	MALE
gormlaith	FEMALE
goske	FEMALE
gosse	MALE
gotmer	MALE
goudje	FEMALE
gouke	MALE
goverdien	FEMALE
govert	MALE
govinda	FEMALE
govinda	FEMALE
gower	MALE
goya	FEMALE
gozewijn	MALE
gozina	FEMALE
grace	FEMALE
gracella	FEMALE
gracia	FEMALE
graciëlla	FEMALE
gracy	FEMALE
grada	FEMALE
gradannie	FEMALE
gradus	MALE
grainne	FEMALE
grania	FEMALE
granna	FEMALE
grant	MALE
gratia	FEMALE
graticia	FEMALE
gratiella	FEMALE
gratienne	FEMALE
grazia	FEMALE
graziana	FEMALE
grazieila	FEMALE
grazielle	FEMALE
greace	FEMALE
greet	FEMALE
greetje	FEMALE
greg	MALE
greger	MALE
gregers	MALE
gregoor	MALE
gregor	MALE
gregoria	FEMALE
gregorio	MALE
gregorius	MALE
gregory	MALE
greham	MALE
greta	FEMALE
gretchen	FEMALE
grete	FEMALE
gretel	FEMALE
gretha	FEMALE
grethe	FEMALE
grian	FEMALE
griet	FEMALE
grieta	FEMALE
grietina	FEMALE
grietje	FEMALE
grietzen	MALE
griffin	MALE
griselda	FEMALE
grisilia	FEMALE
grizelda	FEMALE
gro	FEMALE
grubbelt	MALE
gryt	FEMALE
gualberto	MALE
gualtieri	MALE
gualtiero	MALE
guarniero	MALE
gudbrand	MALE
gudeke	FEMALE
gudi	FEMALE
gudrun	FEMALE
gudrune	FEMALE
gudula	FEMALE
guendalina	FEMALE
guevaro	MALE
guglielmina	FEMALE
guglielmo	MALE
guido	MALE
guidy	FEMALE
guikje	FEMALE
guiliano	MALE
guilio	MALE
guiljam	MALE
guilla	FEMALE
guillaume	MALE
guillelmo	MALE
guillerma	FEMALE
guillermo	MALE
guillian	MALE
guilliano	MALE
guinevere	FEMALE
guinyas	FEMALE
guiote	FEMALE
guite	FEMALE
gul	FEMALE
gulbrand	MALE
gulja	FEMALE
gulsema	FEMALE
gunawan	MALE
gunda	FEMALE
gundar	MALE
gunde	FEMALE
gundel	FEMALE
gunder	MALE
gunhild	FEMALE
gunilla	FEMALE
gunnar	MALE
gunnel	FEMALE
gunner	MALE
gunther	MALE
gust	MALE
gusta	FEMALE
gustaaf	MALE
gustaf	MALE
gustav	MALE
gustava	FEMALE
gustave	FEMALE
gustave	MALE
gustavine	FEMALE
gustavo	MALE
gustavus	MALE
guurt	MALE
guus	MALE
guusje	FEMALE
guust	MALE
guy	MALE
guyan	MALE
guylian	MALE
guyonne	FEMALE
guyvan	MALE
guénaël	FEMALE
gwen	FEMALE
gwenael	MALE
gwenda	FEMALE
gwendolin	FEMALE
gwendolina	FEMALE
gwendoline	FEMALE
gwendolyn	FEMALE
gwendy	FEMALE
gwenhyfwar	FEMALE
gwenn	FEMALE
gwennevera	FEMALE
gwenny	FEMALE
gwijde	MALE
gwydion	MALE
gwyllion	MALE
gwynedd	FEMALE
gwyneth	FEMALE
gwynn	FEMALE
gyalmo	FEMALE
gydo	MALE
gymon	MALE
gys	MALE
gysanne	FEMALE
gysbert	MALE
gysbertus	MALE
gysella	FEMALE
gyselle	FEMALE
györgy	MALE
gèranne	FEMALE
gé	MALE
göran	MALE
gösta	MALE
g’heaven	MALE
haaf	MALE
haakon	MALE
habib	MALE
hacques	MALE
hadassa	FEMALE
hadassah	FEMALE
hadde	MALE
hade	MALE
hademar	MALE
hades	MALE
hadewich	FEMALE
hadewig	FEMALE
hadewij	FEMALE
hadewych	FEMALE
hadia	FEMALE
hadmer	MALE
hadriaan	MALE
haevenly	FEMALE
hafid	MALE
hagar	FEMALE
haico	MALE
haidee	FEMALE
haider	MALE
haije	MALE
haijo	MALE
haike	MALE
haikje	FEMALE
haiko	MALE
hailey	FEMALE
haimoon	MALE
haitske	FEMALE
haje	MALE
hajet	FEMALE
hajo	MALE
hajolt	MALE
hakan	MALE
hakim	MALE
hakima	FEMALE
hakki	MALE
hakon	MALE
hal	MALE
halbe	MALE
halden	MALE
haldor	MALE
halfreida	FEMALE
halfrida	FEMALE
halfrieda	FEMALE
halina	FEMALE
halldor	MALE
halle	FEMALE
halle	MALE
hallie	FEMALE
hallina	FEMALE
hamid	MALE
hamish	MALE
hamke	FEMALE
hamky	FEMALE
hamlet	MALE
hamme	MALE
hammie	FEMALE
hammy	MALE
hamsa	MALE
hamtaro	FEMALE
hamtaro	MALE
han	MALE
hanae	FEMALE
haneloie	FEMALE
hanes	MALE
hang	FEMALE
hanielle	FEMALE
hanjo	MALE
hank	MALE
hanka	FEMALE
hanke	FEMALE
hanlo	MALE
hanna	FEMALE
hannah	FEMALE
hannalore	FEMALE
hannchen	FEMALE
hanne	FEMALE
hanne	MALE
hanneke	FEMALE
hannele	FEMALE
hanneleen	FEMALE
hannelore	FEMALE
hannemarie	FEMALE
hannes	MALE
hanni	FEMALE
hannibal	MALE
hannie	FEMALE
hanno	MALE
hanns	MALE
hanny	FEMALE
hanola	FEMALE
hanola	MALE
hans	MALE
hans-albert	MALE
hans-alexander	MALE
hans-christiaan	MALE
hans-dieter	MALE
hans-joachim	MALE
hans-peter	MALE
hans-werner	MALE
hansine	FEMALE
hansje	FEMALE
hansjörg	MALE
hansko	MALE
hanso	MALE
hanson	MALE
hantje	FEMALE
hantzen	FEMALE
hany	MALE
happy	FEMALE
har	MALE
harald	MALE
harald	MALE
haranga	FEMALE
harbert	MALE
harbrand	MALE
harco	MALE
harda	FEMALE
hardi	MALE
hardwig	MALE
hardwin	MALE
hare	MALE
hariet	FEMALE
hariette	FEMALE
harja	FEMALE
harjan	MALE
harjo	MALE
harko	MALE
harlan	MALE
harld	MALE
harley	MALE
harm	MALE
harm-jan	MALE
harm-jan	MALE
harm-ybo	MALE
harma	FEMALE
harmanda	FEMALE
harmen	MALE
harmina	FEMALE
harmjan	MALE
harmke	FEMALE
harmon	MALE
harnold	MALE
haroen	MALE
harold	MALE
haron	FEMALE
haron	MALE
harpert	MALE
harri	MALE
harrie	MALE
harrie-berta	MALE
harriett	FEMALE
harris	MALE
harrison	MALE
harro	MALE
harry	MALE
hart	MALE
harte	FEMALE
hartger	MALE
harun	MALE
harvey	MALE
harvinon	MALE
harwin	MALE
has	MALE
hassan	MALE
hasse	MALE
hattie	FEMALE
hauke	FEMALE
hava	FEMALE
havel	MALE
hawar	FEMALE
hayat	FEMALE
hayco	MALE
haye	MALE
hayke	FEMALE
hayley	FEMALE
hayley	MALE
hayo	MALE
hayrettin	MALE
hayte	MALE
hayvaa	FEMALE
hazel	FEMALE
heather	FEMALE
heavenly	FEMALE
heavenly	FEMALE
heba	FEMALE
hebe	FEMALE
hebe	MALE
hecate	FEMALE
hector	MALE
hedda	FEMALE
heddi	FEMALE
heddy	FEMALE
hedi	FEMALE
hedika	FEMALE
hedin	MALE
hedrun	FEMALE
hedser	MALE
hedvig	FEMALE
hedwich	FEMALE
hedwig	FEMALE
hedwina	FEMALE
hedy	FEMALE
hedzer	MALE
hefaistos	MALE
hege	FEMALE
heico	MALE
heidelind	FEMALE
heidi	FEMALE
heidrun	FEMALE
heidy	FEMALE
heije	MALE
heika	FEMALE
heike	FEMALE
heiki	MALE
heikko	MALE
heiko	MALE
heimer	MALE
heimerick	MALE
heimert	MALE
heimo	MALE
hein	MALE
heino	MALE
heinrich	MALE
heinrike	FEMALE
heinske	FEMALE
heinz	MALE
heinz-harald	MALE
heinze	MALE
heirick	MALE
hekabe	FEMALE
hektoor	MALE
hektor	MALE
helder	FEMALE
heleen	FEMALE
helen	FEMALE
helena	FEMALE
helene	FEMALE
helga	FEMALE
helge	MALE
helina	FEMALE
helios	MALE
heljan	MALE
helke	FEMALE
hella	FEMALE
helle	FEMALE
helle	MALE
helleen	FEMALE
hellen	FEMALE
heller	MALE
helma	FEMALE
helmer	MALE
helmi	FEMALE
helmich	MALE
helmieke	FEMALE
helmo	MALE
helmrich	MALE
helmut	MALE
helmy	FEMALE
heloise	FEMALE
helsa	FEMALE
hemant	MALE
hemko	MALE
hemma	FEMALE
hemmond	MALE
hendericus	MALE
henderika	FEMALE
henderikus	MALE
henderine	FEMALE
hendri	MALE
hendrica	FEMALE
hendriek	MALE
hendrien	FEMALE
hendrietta	FEMALE
hendriette	FEMALE
hendrik	MALE
hendrik-jan	MALE
hendrika	FEMALE
hendrike	FEMALE
hendrikje	FEMALE
hendrina	FEMALE
hendrinand	MALE
henjo	MALE
henk	MALE
henk-jan	MALE
henneie	FEMALE
henneke	FEMALE
henni	FEMALE
hennie	FEMALE
hennie	MALE
henning	MALE
hennita	FEMALE
henno	MALE
henny	FEMALE
henny	MALE
henra	FEMALE
henri	MALE
henrianne	FEMALE
henrie	MALE
henrieke	FEMALE
henrietta	FEMALE
henriette	FEMALE
henrik	MALE
henrika	FEMALE
henrike	FEMALE
henrique	MALE
henrita	FEMALE
henriëtte	FEMALE
henry	MALE
henryk	MALE
henske	FEMALE
hent	MALE
hera (juno)	FEMALE
heraclio	MALE
herakles	MALE
herald	MALE
heraldo	MALE
herbert	MALE
herberth	MALE
herbertha	FEMALE
herco	MALE
herjan	MALE
herke	MALE
herkje	FEMALE
herko	MALE
herlinde	FEMALE
herm	MALE
herma	FEMALE
herman	MALE
hermance	FEMALE
hermanda	FEMALE
hermann	MALE
hermannus	MALE
hermanus	MALE
hermelijntje	FEMALE
hermelinde	FEMALE
hermen	MALE
hermes	MALE
hermi	FEMALE
hermia	FEMALE
hermien	FEMALE
hermina	FEMALE
hermine	FEMALE
herminette	FEMALE
hermione	FEMALE
hermyn	FEMALE
hernando	MALE
hero	MALE
herold	MALE
herrald	MALE
herre	MALE
herriette	FEMALE
herrik	MALE
herry	MALE
hersley	MALE
herta	FEMALE
hertha	FEMALE
hertine	FEMALE
herve	MALE
herwig	MALE
herwin	MALE
hesje	FEMALE
hesli	MALE
hesse	MALE
hessel	MALE
hesso	MALE
hester	FEMALE
hestia	FEMALE
hetje	FEMALE
hette	MALE
hetty	FEMALE
heurica	FEMALE
heyli	FEMALE
hichan	MALE
hidde	MALE
hideharu	MALE
hidie	FEMALE
hieke	FEMALE
hielke	MALE
hieronymus	MALE
hijke	MALE
hijko	MALE
hijlco	MALE
hike	MALE
hilany	FEMALE
hilary	FEMALE
hilbert	MALE
hilbrand	MALE
hilco	MALE
hild	FEMALE
hild	MALE
hilda	FEMALE
hildagonda	FEMALE
hilde	FEMALE
hildegard	FEMALE
hildegarde	FEMALE
hildegonda	FEMALE
hildemar	FEMALE
hildert	MALE
hildie	FEMALE
hildo	MALE
hildreth	FEMALE
hildretha	FEMALE
hilgert	MALE
hilit	FEMALE
hilja	FEMALE
hilke	FEMALE
hilkert	MALE
hilla	FEMALE
hille	FEMALE
hille	MALE
hillebrand	MALE
hillegiendje	FEMALE
hillegonda	FEMALE
hilleke	FEMALE
hilligje	FEMALE
hilly	FEMALE
hilma	FEMALE
hilse	FEMALE
hiltje	FEMALE
hiltjo	MALE
hilverd	MALE
hind	FEMALE
hinde	FEMALE
hinka	FEMALE
hinke	FEMALE
hinke	MALE
hinkje	FEMALE
hinne	MALE
hinno	MALE
hinse	MALE
hinsje	FEMALE
hinte	MALE
hippodameia	FEMALE
hippoliet	MALE
hippolyte	FEMALE
hippolyte	MALE
hippolytos	MALE
hippomenes	MALE
hirad	MALE
hiram	MALE
hiroshi	MALE
hisco	MALE
hiska	FEMALE
hiske	FEMALE
hiskia	FEMALE
hisse	MALE
hitske	FEMALE
hitte	MALE
hittje	FEMALE
hjalmar	MALE
hjalmr	MALE
hjördis	FEMALE
hoagy	MALE
hoatse	MALE
hob	MALE
hobie	MALE
hoeke	MALE
hoempa	MALE
hokurd	MALE
holden	MALE
holger	MALE
hollin	FEMALE
holly	FEMALE
holm	MALE
holme	MALE
homme	MALE
honey	FEMALE
honor	MALE
honora	FEMALE
honore	MALE
honoree	FEMALE
honorine	FEMALE
hope	FEMALE
horatia	FEMALE
horatio	MALE
horst	MALE
hortense	FEMALE
hortensia	FEMALE
hortensius	MALE
hotse	MALE
hotte	MALE
hotze	MALE
houston	FEMALE
howard	MALE
hrodgar	MALE
hsin-chi	FEMALE
hub	MALE
hubert	MALE
huberta	FEMALE
hubertha	FEMALE
huberthe	FEMALE
hubertina	FEMALE
hubertine	FEMALE
hubertus	MALE
hubrecht	MALE
huck	MALE
huey	MALE
hugh	MALE
hugo	MALE
hugolien	FEMALE
hugues	MALE
huguette	FEMALE
huib	MALE
huiberdien	FEMALE
huiberdina	FEMALE
huibert	MALE
huibje	FEMALE
huig	MALE
huikje	FEMALE
huite	MALE
hulda	FEMALE
humfried	MALE
humphrey	MALE
humphry	MALE
hun	MALE
hunter	FEMALE
hurriyet	FEMALE
huseyin	MALE
huub	MALE
huubke	MALE
huug	MALE
hy	MALE
hyacint	FEMALE
hyacinta	FEMALE
hyacinth	FEMALE
hyacinthus	MALE
hyacintus	MALE
hyke	FEMALE
hylas	MALE
hylgar	FEMALE
hylia	FEMALE
hylke	MALE
hylkje	FEMALE
hylle	MALE
hymke	FEMALE
hyperioon	MALE
hypnos	MALE
hyroyasy	MALE
hågen	MALE
håkan	MALE
håken	MALE
håkon	MALE
hélène	FEMALE
iachimo	MALE
ian	MALE
iana	FEMALE
ianka	FEMALE
ianthe	FEMALE
iapetos	MALE
iasoon	MALE
iasos	MALE
ib	MALE
iba	FEMALE
ibai	MALE
iban	MALE
ibbe	MALE
ibe	MALE
ibella	FEMALE
iben	MALE
ibiza	FEMALE
ibo	MALE
ibrahim	MALE
ibtissam	FEMALE
ica	FEMALE
icha	FEMALE
ichelle	FEMALE
ico	MALE
ida	FEMALE
idalie	FEMALE
idalina	FEMALE
idar	MALE
idas	MALE
idda	FEMALE
iddo	MALE
ide	MALE
idelia	FEMALE
ides	FEMALE
ido	MALE
idona	FEMALE
idonea	FEMALE
idoni	FEMALE
idris	FEMALE
idrissa	FEMALE
ids	MALE
idsart	MALE
idsert	MALE
iduna	FEMALE
idwer	MALE
idzard	MALE
iebe	MALE
iebeltje	FEMALE
iefje	FEMALE
iefke	FEMALE
ieke	FEMALE
ieme	FEMALE
iemke	FEMALE
iemkje	FEMALE
iene	MALE
iense	MALE
iensen	MALE
iente	MALE
iese	MALE
ieske	MALE
ieteke	FEMALE
ieuke	MALE
ieuwe	MALE
ifiej	FEMALE
ifigenia	FEMALE
ifitos	MALE
ige	MALE
iggy	MALE
igino	MALE
igmar	MALE
ignaas	MALE
ignace	MALE
ignard	MALE
ignatia	FEMALE
ignatius	MALE
ignaz	MALE
ignazio	MALE
igo	MALE
igor	MALE
ijada	FEMALE
ijnte	MALE
ijs	MALE
ijsbrand	MALE
ikaros	MALE
ike	MALE
ikea	FEMALE
iken	FEMALE
ilan	MALE
ilana	FEMALE
ilani	FEMALE
ilanit	FEMALE
ilari	MALE
ilayda	FEMALE
ilda	FEMALE
ildebrando	MALE
ildefonso	MALE
ildegarda	FEMALE
ildegonda	FEMALE
ildiko	FEMALE
ile	MALE
ileen	FEMALE
ilen	FEMALE
ilene	FEMALE
ilga	FEMALE
ilham	MALE
ilhame	FEMALE
ilian	MALE
iliana	FEMALE
ilias	MALE
ilina	FEMALE
ilioneus	MALE
ilja	FEMALE
ilja	MALE
iljana	FEMALE
ilka	FEMALE
ilke	FEMALE
ilko	MALE
illia	FEMALE
illidan	MALE
illja	FEMALE
illo	MALE
illse	FEMALE
ilma	FEMALE
ilona	FEMALE
ilonca	FEMALE
ilone	FEMALE
ilonk	FEMALE
ilonka	FEMALE
ilsa	FEMALE
ilsanne	FEMALE
ilse	FEMALE
ilva	FEMALE
ilvi	FEMALE
ilvona	FEMALE
ilvy	FEMALE
ilya	MALE
ilyas	MALE
ima	FEMALE
imaanis	FEMALE
imad	MALE
imago	FEMALE
imalda	FEMALE
iman	MALE
imani	FEMALE
imanuel	MALE
imara	FEMALE
imari	FEMALE
imaya	FEMALE
imbenia	FEMALE
imber	FEMALE
imber	MALE
imca	FEMALE
imco	MALE
ime	MALE
imeen	FEMALE
imelda	FEMALE
imke	FEMALE
imkje	FEMALE
imko	MALE
imma	FEMALE
immacolata	FEMALE
immaculada	FEMALE
immaculata	FEMALE
immakulata	FEMALE
immanuel	MALE
immanuél	MALE
imme	MALE
immeke	FEMALE
immeltje	FEMALE
immy	FEMALE
imogen	FEMALE
imoghean	FEMALE
imora	FEMALE
imre	MALE
imri	FEMALE
imro	MALE
imruh	MALE
ina	FEMALE
inama	FEMALE
inara	FEMALE
inaya	FEMALE
inca	FEMALE
inder	MALE
indi	FEMALE
india	FEMALE
indiana	MALE
indie	FEMALE
indigo	FEMALE
indira	FEMALE
indjomar	MALE
indoe	FEMALE
indra	FEMALE
indra	MALE
indun	FEMALE
indy	FEMALE
indy	MALE
indyra	FEMALE
ine	FEMALE
ineke	FEMALE
ineluki	MALE
ines	FEMALE
inessa	FEMALE
inez	FEMALE
inga	FEMALE
ingbert	MALE
inge	FEMALE
inge	MALE
ingeborg	FEMALE
ingeborgh	FEMALE
ingegerd	FEMALE
ingel	MALE
ingelbert	MALE
ingelhard	MALE
ingelil	FEMALE
ingelill	FEMALE
ingelise	FEMALE
ingelke	MALE
ingelko	MALE
ingelle	MALE
ingemar	MALE
inger	FEMALE
ingerid	FEMALE
ingjeborg	FEMALE
ingle	MALE
ingmar	MALE
ingo	MALE
ingolf	MALE
ingrid	FEMALE
ingvar	MALE
ingvild	FEMALE
ingwer	MALE
ini	FEMALE
inja	FEMALE
inka	FEMALE
inke	FEMALE
inken	FEMALE
inneke	FEMALE
inni	MALE
innie	MALE
innocent	MALE
innocentia	FEMALE
innocentius	MALE
innosance	FEMALE
innozentia	FEMALE
ino	FEMALE
inoa	FEMALE
inocencio	MALE
insa	FEMALE
inse	MALE
insen	FEMALE
inte	FEMALE
inver	MALE
inés	FEMALE
io	FEMALE
ioan	MALE
iody	MALE
iokaste	FEMALE
iole	FEMALE
iommi	FEMALE
ion	MALE
ione	FEMALE
ioon	MALE
ipek	FEMALE
iphigenie	FEMALE
ippolito	MALE
ira	FEMALE
ira	MALE
iran	MALE
irande	FEMALE
iranjes	FEMALE
iraïs	FEMALE
irena	FEMALE
irene	FEMALE
ireneus	MALE
irenke	FEMALE
ires	FEMALE
irida	FEMALE
iridée	FEMALE
irina	FEMALE
irinja	FEMALE
irinka	FEMALE
iris	FEMALE
irma	FEMALE
irme	FEMALE
irmelind	FEMALE
irmelinde	FEMALE
irmenbert	MALE
irmengard	FEMALE
irmgard	FEMALE
irmhild	FEMALE
irmin	MALE
irmina	FEMALE
irmine	FEMALE
irmy	FEMALE
iroelan	FEMALE
irone	FEMALE
iros	MALE
irsha	FEMALE
irvin	MALE
irving	MALE
irvy-anne	FEMALE
iréné	MALE
irés	FEMALE
isa	FEMALE
isaac	MALE
isaak	MALE
isabeau	FEMALE
isabel	FEMALE
isabela	FEMALE
isabella	FEMALE
isabelle	FEMALE
isacco	MALE
isaiah	MALE
isaijah	MALE
isalda	FEMALE
isalinde	FEMALE
isamara	FEMALE
isar	MALE
isaura	FEMALE
isaï	MALE
ischa	MALE
ischel	FEMALE
ise	FEMALE
iselda	FEMALE
iseult	FEMALE
isha	FEMALE
isham	MALE
ishana	FEMALE
ishvara	MALE
isibeal	FEMALE
isidoor	MALE
isidora	FEMALE
isidore	MALE
isilde	FEMALE
isis	FEMALE
isite	FEMALE
iskander	MALE
iske	FEMALE
isleen	FEMALE
ismael	MALE
ismail	MALE
ismay	FEMALE
ismaël	MALE
ismene	FEMALE
ismenia	FEMALE
ismenos	MALE
ismunde	FEMALE
isolda	FEMALE
isolde	FEMALE
isotta	FEMALE
issa	MALE
istvan	MALE
istván	MALE
isza	FEMALE
ita	FEMALE
itchie	MALE
iteke	FEMALE
ito	MALE
itsje	FEMALE
itske	FEMALE
itzel	FEMALE
itzhak	MALE
iuchra	FEMALE
iva	FEMALE
ivan	MALE
ivana	FEMALE
ivanka	FEMALE
ivar	MALE
ive	MALE
iver	MALE
iverna	FEMALE
ives	MALE
ivette	FEMALE
ivo	MALE
ivon	MALE
ivonne	FEMALE
ivor	MALE
ivory	FEMALE
ivuska	FEMALE
ivuška	FEMALE
ivy	FEMALE
iwan	MALE
iwana	FEMALE
iwanka	FEMALE
iwanna	FEMALE
iwar	MALE
iwe	MALE
iwona	FEMALE
iza	FEMALE
izaak	MALE
izabella	FEMALE
izakiël	MALE
izar	FEMALE
izaura	FEMALE
izellah	FEMALE
izia	FEMALE
iziit	FEMALE
iziit	MALE
izmaray	MALE
izmir	MALE
izo	MALE
izzie	FEMALE
iñez	FEMALE
j-lo	FEMALE
jaak	MALE
jaan	MALE
jaanne	FEMALE
jaantje	FEMALE
jaap	MALE
jaap-adriaan	MALE
jaap-jan	MALE
jaap-joris	MALE
jaas	MALE
jaasmijn	FEMALE
jabez	MALE
jabo	MALE
jac	MALE
jacco	MALE
jaccoline	FEMALE
jace	FEMALE
jacek	MALE
jacelyn	FEMALE
jacen	MALE
jacha	FEMALE
jacinda	FEMALE
jacinta	FEMALE
jacinth	FEMALE
jacintha	FEMALE
jacinto	MALE
jack	MALE
jackelien	FEMALE
jackey	FEMALE
jackie	FEMALE
jacklin	FEMALE
jacko	MALE
jacky	FEMALE
jaclyn	FEMALE
jaco	MALE
jacob	MALE
jacoba	FEMALE
jacobien	FEMALE
jacobina	FEMALE
jacobine	FEMALE
jacobus	MALE
jacolien	FEMALE
jacoline	FEMALE
jacomien	FEMALE
jacomijn	FEMALE
jacomine	FEMALE
jacopo	MALE
jacorine	FEMALE
jacq	FEMALE
jacquelien	FEMALE
jacqueline	FEMALE
jacques	MALE
jacquline	FEMALE
jacyntha	FEMALE
jada	FEMALE
jade	FEMALE
jaden	MALE
jadie	FEMALE
jadira	FEMALE
jadith	FEMALE
jadwiga	FEMALE
jadzia	FEMALE
jaean	MALE
jael	MALE
jaella	FEMALE
jaenet	FEMALE
jaentien	FEMALE
jafar	MALE
jafet	MALE
jag	MALE
jagge	MALE
jago	MALE
jahara	FEMALE
jahja	MALE
jahmella	FEMALE
jai	MALE
jaibreyon	MALE
jaidy	MALE
jaike	FEMALE
jaiky	MALE
jailda	FEMALE
jaime	MALE
jaimee	FEMALE
jaimily	FEMALE
jaimy	MALE
jair	MALE
jaira	FEMALE
jairo	MALE
jaironai	MALE
jairzinho	MALE
jaitse	MALE
jaivey	MALE
jake	MALE
jakira	FEMALE
jakke	MALE
jakko	MALE
jako	MALE
jakob	MALE
jakorien	FEMALE
jakubv	MALE
jaleesa	FEMALE
jaleesha	FEMALE
jalen	MALE
jalien	FEMALE
jalil	MALE
jalilo	MALE
jalisa	FEMALE
jalissa	FEMALE
jalke	FEMALE
jalle	MALE
jaloe	FEMALE
jamai	MALE
jamaica	FEMALE
jamal	MALE
jamala	MALE
jamano	MALE
jamay	MALE
jamaí	MALE
jamaï	MALE
james	MALE
jameson	MALE
jametta	FEMALE
jamey	MALE
jamie	FEMALE
jamie	MALE
jamiel	MALE
jamil	MALE
jamila	FEMALE
jamilah	FEMALE
jamilia	FEMALE
jamilla	FEMALE
jamiro	MALE
jamy	MALE
jan	MALE
jan albert	MALE
jan dirk	MALE
jan willem	MALE
jan-arend	MALE
jan-gerrit	MALE
jan-jaap	MALE
jan-joris	MALE
jan-kees	MALE
jan-maarten	MALE
jan-martijn	MALE
jan-michael	MALE
jan-rob	MALE
jan-stefan	MALE
jan-vincent	MALE
jan-willem	MALE
jana	FEMALE
janah	FEMALE
janaika	FEMALE
janara	FEMALE
janaya	FEMALE
janca	FEMALE
janco	MALE
jando	MALE
jane	FEMALE
jane	MALE
janelin	FEMALE
janell	FEMALE
janella	FEMALE
janelle	FEMALE
janet	FEMALE
janette	FEMALE
janey	FEMALE
jango	MALE
jani	FEMALE
janice	FEMALE
janick	MALE
janida	FEMALE
janie	FEMALE
janiek	FEMALE
janien	FEMALE
janik	MALE
janika	FEMALE
janillio	MALE
janina	FEMALE
janine	FEMALE
janinka	FEMALE
janique	FEMALE
janis	FEMALE
janita	FEMALE
janka	FEMALE
janke	FEMALE
janko	MALE
jann	FEMALE
jann	MALE
janna	FEMALE
jannah	FEMALE
jannai	MALE
janne	FEMALE
janneau	MALE
janneke	FEMALE
jannelies	FEMALE
janneman	MALE
jannemarie	FEMALE
jannemieke	FEMALE
jannerieke	FEMALE
jannes	MALE
jannet	FEMALE
jannetie	FEMALE
jannette	FEMALE
janney	FEMALE
jannick	MALE
jannie	FEMALE
jannieke	FEMALE
jannieta	FEMALE
jannigje	FEMALE
jannik	MALE
jannike	FEMALE
jannink	MALE
jannis	MALE
jannita	FEMALE
janno	MALE
janny	FEMALE
jano	MALE
janoah	MALE
janoe	MALE
janos	MALE
janothan	MALE
janou	FEMALE
janou	MALE
janouk	FEMALE
janoux	FEMALE
jans	FEMALE
jans	MALE
jansie	FEMALE
jansje	FEMALE
janske	FEMALE
janson	MALE
jante	FEMALE
janten	MALE
janthe	FEMALE
jantien	FEMALE
jantiena	FEMALE
jantiene	FEMALE
jantina	FEMALE
jantine	FEMALE
jantje	FEMALE
jantsje	FEMALE
janus	MALE
januska	FEMALE
jany	FEMALE
jany	MALE
jaochim	MALE
jaouad	MALE
jap	MALE
japco	MALE
japik	MALE
japke	MALE
jaquan	MALE
jaques	MALE
jara	FEMALE
jara	MALE
jaralsey	FEMALE
jarco	MALE
jard	FEMALE
jarda	MALE
jardena	FEMALE
jardi	FEMALE
jardi	MALE
jared	MALE
jarell	MALE
jari	MALE
jarich	MALE
jarik	MALE
jarill	FEMALE
jarill	MALE
jarin	MALE
jarinda	FEMALE
jarinde	FEMALE
jarinka	FEMALE
jarino	MALE
jark	MALE
jarka	FEMALE
jarl	MALE
jarmaine	MALE
jarmilla	FEMALE
jarmo	MALE
jarn	MALE
jarne	MALE
jarni	MALE
jarnica	FEMALE
jarnick	MALE
jarno	MALE
jaro	MALE
jarod	MALE
jaromir	MALE
jaron	MALE
jarre	MALE
jarrik	MALE
jarrin	MALE
jarst	MALE
jarsto	MALE
jart	MALE
jarvia	FEMALE
jas	MALE
jascha	MALE
jaschenka	FEMALE
jasia	FEMALE
jasja	MALE
jasmien	FEMALE
jasmijn	FEMALE
jasmin	FEMALE
jasmina	FEMALE
jasmine	FEMALE
jason	MALE
jasper	MALE
jasperien	FEMALE
jasperina	FEMALE
jaspert	MALE
jassu	MALE
jaswinder	MALE
jauke	MALE
jauro	MALE
java	FEMALE
javan	MALE
javanata	FEMALE
javelin	FEMALE
javelin	FEMALE
javier	MALE
javina	FEMALE
jawed	MALE
jay	FEMALE
jay	MALE
jay-jay	MALE
jaya	FEMALE
jaydee	MALE
jayden	MALE
jaydi	FEMALE
jaylee	FEMALE
jaylow	MALE
jaynee	FEMALE
jazon	MALE
jazzy	FEMALE
jaïr	MALE
jean	MALE
jean louis	MALE
jean-antoine	MALE
jean-carlo	MALE
jean-christophe	MALE
jean-claude	MALE
jean-louis	MALE
jean-luc	MALE
jean-michel	MALE
jean-paul	MALE
jean-pierre	MALE
jeanell	FEMALE
jeanet	FEMALE
jeanette	FEMALE
jeanine	FEMALE
jeanique	FEMALE
jeanne	FEMALE
jeannetta	FEMALE
jeannette	FEMALE
jeannine	FEMALE
jeannity	FEMALE
jeannot	MALE
jeanny	FEMALE
jeano	MALE
jeanot	FEMALE
jeantine	FEMALE
jearon	FEMALE
jeason	MALE
jebb	MALE
jechonja	FEMALE
jedidia	FEMALE
jedidja	FEMALE
jedinja	FEMALE
jeen	MALE
jeevan	MALE
jef	MALE
jeff	MALE
jeff-herb	MALE
jeffrey	MALE
jeffried	MALE
jeffry	MALE
jefry	MALE
jefta	MALE
jehan	MALE
jehudi	MALE
jeike	FEMALE
jeisyl	FEMALE
jel	MALE
jelaisa	FEMALE
jelani	MALE
jelbrich	FEMALE
jelco	MALE
jeldau	FEMALE
jeldert	MALE
jelena	FEMALE
jelenka	FEMALE
jelger	MALE
jelia	FEMALE
jelien	FEMALE
jelies	MALE
jelika	FEMALE
jelinka	FEMALE
jelinke	FEMALE
jelisa	FEMALE
jelisha	FEMALE
jelissa	FEMALE
jelka	FEMALE
jelke	FEMALE
jella	FEMALE
jelle	MALE
jellen	FEMALE
jellica	FEMALE
jellina	FEMALE
jellis	MALE
jelmar	MALE
jelmer	MALE
jelmo	MALE
jels	MALE
jelse	FEMALE
jelsie	FEMALE
jelske	FEMALE
jelt	MALE
jelte	MALE
jeltje	FEMALE
jelyn	FEMALE
jelyse	FEMALE
jemaine	FEMALE
jemairo	MALE
jemario	MALE
jemi	FEMALE
jemima	FEMALE
jemé	MALE
jena	FEMALE
jendis	MALE
jendo	MALE
jendrik	MALE
jene	FEMALE
jenice	FEMALE
jenieke	FEMALE
jenieta	FEMALE
jenifer	FEMALE
jenita	FEMALE
jenna	FEMALE
jenne	MALE
jenneke	FEMALE
jenneken	FEMALE
jenni	FEMALE
jennica	FEMALE
jennie	FEMALE
jennifer	FEMALE
jenniffer	FEMALE
jennigje	FEMALE
jenniley	FEMALE
jennis	MALE
jennita	FEMALE
jenno	MALE
jenny	FEMALE
jens	MALE
jens-uwe	MALE
jensen	MALE
jensine	FEMALE
jenske	FEMALE
jenson	MALE
jent	MALE
jente	FEMALE
jente	MALE
jenten	MALE
jenthe	FEMALE
jentine	FEMALE
jentl	FEMALE
jentske	FEMALE
jeoffrey	MALE
jeol	MALE
jep	MALE
jephta	FEMALE
jeppe	MALE
jera	FEMALE
jerel	FEMALE
jerell	FEMALE
jerell	MALE
jerely	FEMALE
jeremay	MALE
jeremi	MALE
jeremia	MALE
jeremias	MALE
jeremie	MALE
jeremy	MALE
jeremy brian	MALE
jerenaito	MALE
jerica	FEMALE
jerico	MALE
jerien	MALE
jerina	FEMALE
jerke	MALE
jerko	MALE
jerliena	FEMALE
jermain	MALE
jermaine	MALE
jermey	MALE
jermias	MALE
jermo	MALE
jerna	FEMALE
jerne	MALE
jerney	FEMALE
jerno	MALE
jeroen	MALE
jerom	MALE
jerome	MALE
jeromy	MALE
jeron	MALE
jeronimo	MALE
jeroom	MALE
jeroule	FEMALE
jeroy	MALE
jerre	MALE
jerre-jan	MALE
jerrel	MALE
jerren	MALE
jerrold	MALE
jerry	MALE
jerry-kevin	MALE
jersey	MALE
jerusha	FEMALE
jervel	MALE
jerven	MALE
jervin	MALE
jerwel	MALE
jerze	MALE
jerzy	MALE
jerónimo	MALE
jeröm	MALE
jesca	FEMALE
jesceyro	MALE
jeshaja	MALE
jeshuroen	MALE
jeska	FEMALE
jeske	FEMALE
jesline	FEMALE
jesme	FEMALE
jesmine	FEMALE
jesmé	FEMALE
jesper	MALE
jesper	MALE
jesperi	MALE
jess	MALE
jessa	FEMALE
jessamy	FEMALE
jesse	MALE
jesse-james	MALE
jessey	MALE
jessi	FEMALE
jessica	FEMALE
jessie	FEMALE
jessika	FEMALE
jessin	MALE
jessina	FEMALE
jesslin	FEMALE
jessy	FEMALE
jessy	MALE
jesta	FEMALE
jesta	MALE
jestah	FEMALE
jestah	MALE
jester	FEMALE
jesús	MALE
jet	FEMALE
jethro	MALE
jetje	FEMALE
jetske	FEMALE
jetsko	MALE
jett	FEMALE
jetta	FEMALE
jettchebn	FEMALE
jette	FEMALE
jettie	FEMALE
jetty	FEMALE
jetze	MALE
jeunessa	FEMALE
jevgeni	MALE
jevon	MALE
jewa	FEMALE
jewan	MALE
jewanah	MALE
jewel	FEMALE
jezebel	FEMALE
jezus	MALE
jezz	MALE
jhenoek	FEMALE
jhonny	MALE
jianna	FEMALE
jibbe	MALE
jidde	MALE
jiddo	MALE
jielis	MALE
jielus	MALE
jifke	FEMALE
jigael	MALE
jigal	MALE
jijs	MALE
jikke	FEMALE
jilco	MALE
jildar	MALE
jildau	FEMALE
jildert	MALE
jildes	FEMALE
jildo	MALE
jildou	FEMALE
jilena	FEMALE
jilis	MALE
jilke	FEMALE
jill	FEMALE
jill	MALE
jilla	FEMALE
jille	MALE
jilleke	FEMALE
jilles	MALE
jillian	FEMALE
jillis	MALE
jillisa	FEMALE
jilly	FEMALE
jilmar	MALE
jilphana	FEMALE
jils	MALE
jilske	FEMALE
jim	MALE
jimena	FEMALE
jimi	MALE
jimme	MALE
jimmy	MALE
jina	FEMALE
jindy	FEMALE
jinge	FEMALE
jinke	FEMALE
jinne	MALE
jinte	FEMALE
jinten	MALE
jinty	FEMALE
jinx	FEMALE
jip	FEMALE
jip	MALE
jipke	FEMALE
jippe	MALE
jiri	MALE
jirke	FEMALE
jirmey	MALE
jiry	MALE
jisca	FEMALE
jisk	MALE
jiska	FEMALE
jiska	MALE
jiske	FEMALE
jismar	MALE
jismé	FEMALE
jisse	FEMALE
jissy	FEMALE
jitcia	FEMALE
jithran	MALE
jitka	FEMALE
jitse	MALE
jitske	FEMALE
jitte	FEMALE
jitze	MALE
jiwan	MALE
jna	FEMALE
jo	MALE
joachim	MALE
joachim-jeroen	MALE
joah	MALE
joalina	FEMALE
joan	MALE
joandi	FEMALE
joanita	FEMALE
joanna	FEMALE
joanne	FEMALE
joannes	MALE
joannou	MALE
joany	FEMALE
joao	MALE
joaquin	MALE
joaquím	MALE
joas	MALE
job	MALE
jobbe	MALE
jobeth	FEMALE
jobeth	FEMALE
jobien	FEMALE
jobst	MALE
joby	MALE
jochem	MALE
jochen	MALE
jochgem	MALE
jochum	MALE
jock	MALE
jocé	FEMALE
jodi	FEMALE
jodoc	MALE
jodocus	MALE
jody	MALE
joe	MALE
joeke	FEMALE
joekje	FEMALE
joel	MALE
joelja	FEMALE
joella	FEMALE
joelle	FEMALE
joely	FEMALE
joep	MALE
joere	MALE
joeri	MALE
joerie	MALE
joes	MALE
joeska	FEMALE
joesra	FEMALE
joey	MALE
joeye	MALE
jofan	FEMALE
joffrey	MALE
jogchem	MALE
johan	MALE
johan-olaf	MALE
johanan	MALE
johann	MALE
johanna	FEMALE
johanne	FEMALE
johanneke	FEMALE
johannes	MALE
johanney	MALE
johanni	FEMALE
johannis	MALE
johara	FEMALE
joheron	MALE
john	MALE
john-eliot	MALE
john-gabriel	MALE
john-paul	MALE
johna	FEMALE
johnny	MALE
joi	MALE
joia	MALE
jojan	MALE
jojanneke	FEMALE
joke	FEMALE
jokebeth	FEMALE
jokobe	FEMALE
jokum	MALE
jolan	MALE
jolanda	FEMALE
jolande	FEMALE
jolando	MALE
jolanthe	FEMALE
joleen	FEMALE
jolein	FEMALE
jolenda	FEMALE
jolene	FEMALE
jolenta	FEMALE
jolenthe	FEMALE
jolet	FEMALE
jolette	FEMALE
jolice	FEMALE
jolie	FEMALE
jolien	FEMALE
joliena	FEMALE
jolier	FEMALE
jolier	MALE
jolies	FEMALE
jolijn	FEMALE
jolin	FEMALE
jolina	FEMALE
jolinda	FEMALE
joline	FEMALE
jolique	FEMALE
jolisa	FEMALE
jolise	FEMALE
jolita	FEMALE
jolke	MALE
jolle	MALE
jolque	FEMALE
jolt	MALE
jolyn	FEMALE
jolynn	FEMALE
jomima	FEMALE
jomme	MALE
jon	MALE
jona	MALE
jonah	MALE
jonalien	FEMALE
jonaline	FEMALE
jonas	MALE
jonathan	MALE
jondalar	MALE
jonella	FEMALE
jones	MALE
jonge	MALE
joni	FEMALE
joni	MALE
jonie	FEMALE
jonina	FEMALE
jonine	FEMALE
jonna	FEMALE
jonne	MALE
jonni	MALE
jonno	MALE
jons	MALE
jonty	MALE
jony	MALE
joof	MALE
jools	MALE
joonas	MALE
joop	MALE
joos	MALE
joosie	FEMALE
joosje	FEMALE
jooske	FEMALE
joost	MALE
jop	MALE
jopi	MALE
jopie	FEMALE
joplin	FEMALE
joppa	FEMALE
joppe	MALE
jor	MALE
jorai	MALE
joram	MALE
joran	MALE
joran-dirk	MALE
jorasio	MALE
jord	MALE
jorda	FEMALE
jordan	FEMALE
jordan	MALE
jordana	FEMALE
jordanus	MALE
jorden	MALE
jordena	FEMALE
jordi	MALE
jordin	MALE
jordy	MALE
jordy-joël	MALE
jore	MALE
jorein	FEMALE
joreintje	FEMALE
jorely	MALE
joren	FEMALE
joren	MALE
jorg	MALE
jorge	MALE
jorgen	MALE
jorgine	FEMALE
jorgo	MALE
jorgos	MALE
jori	MALE
jorian	MALE
jorick	MALE
joridan	MALE
jorieke	FEMALE
jorien	MALE
joriette	FEMALE
jorijn	FEMALE
jorik	MALE
jorike	FEMALE
jorina	FEMALE
jorinda	FEMALE
jorinde	FEMALE
jorine	FEMALE
jorinho	MALE
jorinne	FEMALE
joris	MALE
joris-jan	MALE
joriska	FEMALE
jorit	MALE
jorita	FEMALE
jorith	FEMALE
jork	MALE
jorn	MALE
jorna	FEMALE
jorne	MALE
jorre	MALE
jorren	MALE
jorrie	FEMALE
jorrik	MALE
jorrit	MALE
jorryt	MALE
jorrín	MALE
jort	MALE
jorunn	FEMALE
jorvin	MALE
jorwan	MALE
jory	MALE
jos	MALE
josbert	MALE
josce	FEMALE
jose	FEMALE
jose	MALE
josef	MALE
josefa	FEMALE
joselien	FEMALE
joselin	FEMALE
joseph	MALE
josepha	FEMALE
josephien	FEMALE
josephina	FEMALE
josephine	FEMALE
josephus	MALE
josette	FEMALE
josey	MALE
josh	MALE
joshua	MALE
josia	MALE
josias	MALE
josie	FEMALE
josien	FEMALE
josin	MALE
josina	FEMALE
josine	FEMALE
josipa	FEMALE
josita	FEMALE
josja	MALE
josjah	FEMALE
josje	FEMALE
josjua	FEMALE
joska	FEMALE
joska	MALE
joske	FEMALE
josquina	FEMALE
josry	MALE
joss	MALE
josse	MALE
jost	MALE
josta	FEMALE
jostein	MALE
joswant	MALE
josy	FEMALE
josé	MALE
josée	FEMALE
jotham	MALE
joti	MALE
jou	MALE
jouad	MALE
joucke	MALE
jouk	MALE
jouke	MALE
joukje	FEMALE
journey	FEMALE
joury	MALE
jovancka	FEMALE
jovanka	FEMALE
jovanni	MALE
jovi	MALE
jovita	FEMALE
jowan	MALE
jowena	FEMALE
jowi	MALE
jowy	MALE
joy	FEMALE
joya	FEMALE
joyca	FEMALE
joyce	FEMALE
joyceline	FEMALE
joyja	FEMALE
joylia	FEMALE
joylin	FEMALE
jozef	MALE
jozefien	FEMALE
jozelijn	FEMALE
jozeph	MALE
jozet	FEMALE
jozette	FEMALE
jozien	FEMALE
jozra	FEMALE
jozua	MALE
joão	MALE
joël	MALE
joëlla	FEMALE
joëlle	FEMALE
joëly	FEMALE
jris	FEMALE
jualita	FEMALE
juan	MALE
juan-carlo	MALE
juana	FEMALE
juanita	FEMALE
juanito	MALE
jubbe	MALE
jubert	MALE
jubo	MALE
judah	MALE
judas	MALE
judiana	FEMALE
judith	FEMALE
juditta	FEMALE
judy	FEMALE
juhana	FEMALE
juhani	MALE
jula	FEMALE
julcsa	FEMALE
jule	FEMALE
julene	FEMALE
jules	MALE
julez	FEMALE
julia	FEMALE
julian	MALE
juliana	FEMALE
julianne	FEMALE
julie	FEMALE
julien	MALE
juliet	FEMALE
juliette	FEMALE
julika	FEMALE
juline	FEMALE
julio	MALE
julisca	FEMALE
julita	FEMALE
julius	MALE
jullian	MALE
jullie	FEMALE
july	FEMALE
jum	MALE
juna	FEMALE
june	FEMALE
junior	MALE
juno	MALE
junus	MALE
jur	MALE
jurfaas	MALE
jurg	MALE
jurgen	MALE
jurgen daniel	MALE
jurgine	FEMALE
jurgo	MALE
juri	MALE
juriaan	MALE
jurian	MALE
jurien	MALE
jurij	MALE
jurjen	MALE
jurma	FEMALE
jurmen	MALE
jurn	MALE
jurnel	MALE
jurney	FEMALE
jurny	FEMALE
jurre	MALE
jurriaan	MALE
jurrian	MALE
jurriana	FEMALE
jurrie	MALE
jurriejan	MALE
jurrien	MALE
jurrijn	MALE
jurrit	MALE
jurriën	MALE
jurry	MALE
jurryt	MALE
jurwin	MALE
jussi	MALE
just	MALE
justa	FEMALE
justin	MALE
justina	FEMALE
justine	FEMALE
justus	MALE
justyna	FEMALE
jutta	FEMALE
juuk	MALE
juul	MALE
juulke	FEMALE
juulke	MALE
juup	MALE
juus	MALE
juwelette	FEMALE
juwell	FEMALE
juwin	MALE
juwita	FEMALE
jylam	MALE
jynor	MALE
jyrna	FEMALE
jytte	FEMALE
jytthe	FEMALE
jóel	MALE
jörg	MALE
jörgen	MALE
jørgen	MALE
júlide	FEMALE
jürn	MALE
kaan	MALE
kaarina	FEMALE
kaatje	FEMALE
kaay	MALE
kabie	MALE
kader	MALE
kadir	MALE
kadmos	MALE
kai	MALE
kaia	FEMALE
kaikoura	MALE
kaileigh	FEMALE
kaily	FEMALE
kain	MALE
kaine	MALE
kaira	FEMALE
kaitlin	FEMALE
kaitly	FEMALE
kaj	MALE
kaja	FEMALE
kaja	FEMALE
kajill	FEMALE
kajill	MALE
kajo	MALE
kajsa	FEMALE
kaka	FEMALE
kala	FEMALE
kalaya	FEMALE
kalaïs	MALE
kalchas	MALE
kalijn	FEMALE
kalina	FEMALE
kalindi	FEMALE
kalinka	FEMALE
kalista	FEMALE
kalisto	MALE
kalja	FEMALE
kalle	MALE
kalleke	FEMALE
kallie	MALE
kalliope	FEMALE
kallista	FEMALE
kallisto	FEMALE
kalman	MALE
kalypso	FEMALE
kamani	FEMALE
kamani	FEMALE
kamer	FEMALE
kamiel	MALE
kamila	FEMALE
kamilia	FEMALE
kamilla	FEMALE
kamille	FEMALE
kanar	FEMALE
kanat	MALE
kandy	FEMALE
kane	MALE
kanisha	FEMALE
kanjanee	FEMALE
kanouchy	MALE
kanter	MALE
kaori	FEMALE
kara	FEMALE
karaja	FEMALE
karcie	FEMALE
karel	MALE
karen	FEMALE
karen	FEMALE
karenina	FEMALE
karenza	FEMALE
kari	FEMALE
kari-anne	FEMALE
karia	FEMALE
karian	FEMALE
karianka	FEMALE
karianne	FEMALE
kariem	MALE
karien	FEMALE
karijn	FEMALE
karik	MALE
karika	FEMALE
karim	MALE
karima	FEMALE
karin	FEMALE
karina	FEMALE
karine	FEMALE
karisia	FEMALE
karita	FEMALE
kariyn	FEMALE
karl	MALE
karla	FEMALE
karlien	FEMALE
karlijn	FEMALE
karline	FEMALE
karlita	FEMALE
karlo	MALE
karlyn	FEMALE
karmi	FEMALE
karmien	FEMALE
karna	FEMALE
karni	FEMALE
karol	FEMALE
karol	MALE
karola	FEMALE
karolien	FEMALE
karolina	FEMALE
karolinda	FEMALE
karoline	FEMALE
karolinka	FEMALE
karoly	FEMALE
karoy	MALE
kars	MALE
karsientje	FEMALE
karst	MALE
karsten	MALE
karstjen	MALE
kart	MALE
kartini	FEMALE
karun	MALE
karwin	MALE
kas	MALE
kashka	FEMALE
kashmir	MALE
kasia	FEMALE
kasimir	MALE
kaspar	MALE
kasper	MALE
kasperina	FEMALE
kassandra	FEMALE
kassiopeia	FEMALE
kasten	MALE
kastoor	MALE
kasym	MALE
kat	FEMALE
kata	FEMALE
katalin	FEMALE
katarina	FEMALE
katchina	FEMALE
kate	FEMALE
katelijn	FEMALE
kateøina	FEMALE
katharina	FEMALE
katharine	FEMALE
kathe	FEMALE
kathelijn	FEMALE
kathelyn	FEMALE
katherine	FEMALE
kathi	FEMALE
kathleen	FEMALE
kathrin	FEMALE
kathrine	FEMALE
kathy	FEMALE
kati	FEMALE
katia	FEMALE
katie	FEMALE
katina	FEMALE
katinca	FEMALE
katinka	FEMALE
katja	FEMALE
katjana	FEMALE
katjuscka	FEMALE
katka	FEMALE
katleen	FEMALE
katlheen	FEMALE
kato	FEMALE
katoo	FEMALE
katouscha	FEMALE
katrien	FEMALE
katrijn	FEMALE
katrijne	FEMALE
katrin	FEMALE
katty	FEMALE
katusha	FEMALE
kay	MALE
kaya	FEMALE
kayan	MALE
kayceigh	MALE
kaycey	MALE
kayla	FEMALE
kayle	FEMALE
kaylee	FEMALE
kayleigh	FEMALE
kayliam	MALE
kaylian	MALE
kaylin	FEMALE
kayne	MALE
kayr	MALE
kaytlin	FEMALE
ke	FEMALE
kea	FEMALE
keandro	MALE
keanu	MALE
keauna	FEMALE
keavy	FEMALE
keely	FEMALE
keenen	MALE
kees	MALE
keet	FEMALE
kefeus	MALE
keijo	MALE
keimpe	MALE
keiran	MALE
keisha	FEMALE
keith	MALE
keith-lin	FEMALE
keje	MALE
kekei	MALE
kekrops	MALE
kelcie	MALE
kelcy	FEMALE
keldon	MALE
keleigh	FEMALE
kelhsey	FEMALE
kelie	FEMALE
kelis	FEMALE
kellie	FEMALE
kelly	FEMALE
kelly	MALE
kelsey	FEMALE
kelsey	MALE
kelsy	FEMALE
kelt	MALE
kelvin	MALE
kem	FEMALE
kemi	FEMALE
kempen	MALE
ken	MALE
kenan	MALE
kendra	FEMALE
kenize	FEMALE
kenji	MALE
kenley	MALE
kenn	MALE
kennard	MALE
kennedy	FEMALE
kennedy	MALE
kennet	MALE
kenneth	MALE
kennly	FEMALE
kenny	MALE
keno	MALE
kenrick	MALE
kent	MALE
kente	FEMALE
kenza	FEMALE
kenzie	MALE
kenzo	MALE
kenzy	FEMALE
keo	MALE
keoma	FEMALE
keon	MALE
keona	FEMALE
keonie	FEMALE
kera	FEMALE
keran	MALE
kerbina	FEMALE
kerenza	FEMALE
kerian	MALE
keriem	MALE
kerima	FEMALE
kerina	FEMALE
kerr	MALE
kerry	FEMALE
kersen	MALE
kersi	MALE
kersje	FEMALE
kerst	MALE
kersten	FEMALE
kerstin	FEMALE
kervin	MALE
kerwin	MALE
kes	MALE
keshia	FEMALE
kessie	FEMALE
kester	MALE
ketty	FEMALE
keup	MALE
keven	MALE
kevin	MALE
kevoe	FEMALE
kew	MALE
keyana	FEMALE
keye	MALE
keympe	MALE
keyna	FEMALE
keyx	MALE
keziah	MALE
kezja	FEMALE
khalid	MALE
khelian	MALE
khiron	MALE
kian	MALE
kiana	FEMALE
kiana	FEMALE
kiana	MALE
kiani	FEMALE
kiara	FEMALE
kick	MALE
kicky	FEMALE
kid	MALE
kiefer	MALE
kiekel	MALE
kiekie	FEMALE
kier	MALE
kieran	MALE
kieron	MALE
kika	FEMALE
kiki	FEMALE
kiki	MALE
kikiann	FEMALE
kiko	MALE
kileen	FEMALE
kileisha	FEMALE
kiley	MALE
kilian	MALE
killian	MALE
kim	FEMALE
kim	MALE
kimber	FEMALE
kimberi	FEMALE
kimberlee	MALE
kimberley	FEMALE
kimberlie	FEMALE
kimberly	FEMALE
kimbly	FEMALE
kimbo	MALE
kimbolina	FEMALE
kimi	MALE
kimiko	FEMALE
kimja	FEMALE
kimm	FEMALE
kimmy	FEMALE
kimoi	MALE
kimora	FEMALE
kinaï	MALE
kinda	FEMALE
kinge	FEMALE
kingsley	MALE
kino	MALE
kinsey	FEMALE
kinyas	MALE
kinzly	FEMALE
kio	MALE
kiomi	FEMALE
kion	MALE
kiona	FEMALE
kira	FEMALE
kiran	FEMALE
kiran	MALE
kirby	FEMALE
kirby	MALE
kirelo	MALE
kiria	FEMALE
kirian	MALE
kiril	MALE
kirill	MALE
kirina	FEMALE
kirk	MALE
kirna	FEMALE
kirsi	FEMALE
kirsten	FEMALE
kirsten	MALE
kirsti	FEMALE
kirstin	FEMALE
kirstine	FEMALE
kirsty	FEMALE
kiruna	FEMALE
kiry	FEMALE
kis	FEMALE
kisha	FEMALE
kishan	MALE
kit	MALE
kito	MALE
kittie	FEMALE
kitty	FEMALE
kiwine	FEMALE
kizzy	FEMALE
kjeld	MALE
kjell	MALE
kjell-ake	MALE
kjelt	MALE
kjersti	FEMALE
kjetil-andre	MALE
kjetl	MALE
kjille	FEMALE
kjoe	FEMALE
klaar	FEMALE
klaart	FEMALE
klaartje	FEMALE
klaas	MALE
klaasje	FEMALE
klae	FEMALE
klara	FEMALE
klari	FEMALE
klarieke	FEMALE
klarina	FEMALE
klarinda	FEMALE
klarissa	FEMALE
klaska	FEMALE
klaske	FEMALE
klaudia	FEMALE
klaus	MALE
klaus-maria	MALE
klazien	FEMALE
klazina	FEMALE
kleiske	FEMALE
klem	MALE
klemens	MALE
klement	MALE
klementia	FEMALE
klementine	FEMALE
kleopatra	FEMALE
klijn	MALE
klio	FEMALE
klon	MALE
kloris	MALE
klurk	MALE
klymene	FEMALE
knillis	MALE
knjillis	MALE
ko	MALE
kobe	MALE
kobus	MALE
koeala	FEMALE
koeala	MALE
koen	MALE
koenraad	MALE
koers	MALE
koert	MALE
koios	MALE
kola	MALE
kole	FEMALE
kolina	FEMALE
kollo	MALE
komotrut	FEMALE
konda	MALE
konni	MALE
konrad	MALE
konstantia	FEMALE
konstanza	FEMALE
konstanze	FEMALE
kontiki	MALE
koos	MALE
koosie	FEMALE
koosje	FEMALE
kootje	FEMALE
kor	MALE
kora	FEMALE
kordula	FEMALE
korien	FEMALE
korinda	FEMALE
korinna	FEMALE
korinne	FEMALE
korinthe	FEMALE
korline	FEMALE
kornee	MALE
korneel	MALE
kornel	MALE
kornelia	FEMALE
kornelie	FEMALE
kornelis	MALE
kors	MALE
korsten	MALE
korstiaan	MALE
korving	MALE
koré	FEMALE
kosja	MALE
kostas	MALE
kouthar	FEMALE
kranja	FEMALE
kratjella	FEMALE
krelis	MALE
kren	FEMALE
kreoesa	FEMALE
kreoon	MALE
kresta	FEMALE
kreta	FEMALE
kriemhild	FEMALE
kriemhilde	FEMALE
krijn	MALE
krijno	MALE
krijns	MALE
kris	MALE
krist	MALE
krista	FEMALE
kriste	FEMALE
kristel	FEMALE
krister	MALE
kristiaan	MALE
kristian	MALE
kristiane	FEMALE
kristianne	FEMALE
kristie	FEMALE
kristien	FEMALE
kristin	FEMALE
kristina	FEMALE
kristine	FEMALE
kristof	MALE
kristoff	MALE
kristoffelina	FEMALE
kristy	FEMALE
krobon	MALE
kryn	MALE
krystian	MALE
krystle	FEMALE
krystyna	FEMALE
kuba	MALE
kukuli	FEMALE
kuna	FEMALE
kunera	FEMALE
kunibert	MALE
kunigunda	FEMALE
kunigunde	FEMALE
kunissa	FEMALE
kuno	MALE
kurt	MALE
kurti	MALE
kutt	MALE
kwint	MALE
kwinton	MALE
kyan	MALE
kyana	FEMALE
kyandro	MALE
kyani	MALE
kyanie	FEMALE
kyano	MALE
kyanu	MALE
kyara	FEMALE
kyenne	FEMALE
kyenno	MALE
kyle	MALE
kylene	FEMALE
kylia	FEMALE
kylian	FEMALE
kylie	FEMALE
kyllian	MALE
kym	FEMALE
kyma	FEMALE
kymm	FEMALE
kyo	MALE
kyona	FEMALE
kyonne	FEMALE
kyra	FEMALE
kyran	MALE
kyrian	MALE
kyrill	MALE
kyrra	FEMALE
kyscha	FEMALE
kythana	FEMALE
kyzikos	MALE
käthe	FEMALE
la-tavia	FEMALE
la-toya	FEMALE
labam	MALE
laban	MALE
labhaoise	FEMALE
lacey	FEMALE
lachesis	FEMALE
ladonna	FEMALE
laetatia	FEMALE
laetis	FEMALE
laetitia	FEMALE
laflarsama	FEMALE
lafredia	FEMALE
lagartija	FEMALE
lagu	FEMALE
laguna	FEMALE
laia	FEMALE
laika	FEMALE
laila	FEMALE
laisha	FEMALE
laja	FEMALE
lajoany	FEMALE
lajos	MALE
lakeisha	FEMALE
lakhicha	FEMALE
lakiesha	FEMALE
lakischa	FEMALE
lakisha	FEMALE
lale	FEMALE
lali	FEMALE
lalita	FEMALE
lallie	FEMALE
lalo	MALE
lamar	MALE
lambal	FEMALE
lambal	MALE
lambert	MALE
lambertus	MALE
lamby	MALE
lammert	MALE
lammie	FEMALE
lammy	FEMALE
lamont	MALE
lamy	FEMALE
lamy	MALE
lana	FEMALE
lance	MALE
lancelot	MALE
landa	FEMALE
lander	MALE
landor	MALE
landra	FEMALE
laney	FEMALE
lanfrey	MALE
langdon	MALE
langston	MALE
lani	FEMALE
lanikki	FEMALE
lanikky	FEMALE
lanisha	FEMALE
lanouna	FEMALE
lans	MALE
lanzo	MALE
laokoöon	MALE
laquinta	FEMALE
lara	FEMALE
laraya	FEMALE
lard	MALE
lardo	MALE
lare	FEMALE
largo	MALE
larinda	FEMALE
larisa	FEMALE
larissa	FEMALE
larkje	FEMALE
larrain	FEMALE
larry	MALE
lars	MALE
larsina	FEMALE
larsine	FEMALE
las	MALE
lasair	FEMALE
lasairiona	FEMALE
lassar	FEMALE
lasse	MALE
laszlo	MALE
latanja	FEMALE
latasja	FEMALE
latavia	FEMALE
latavia	FEMALE
latavia	FEMALE
latifa	FEMALE
latisha	FEMALE
latishia	FEMALE
latoya	FEMALE
lau	MALE
laudine	FEMALE
laur	MALE
laura	FEMALE
laura sue	FEMALE
laura-jean	FEMALE
lauraine	FEMALE
lauran	MALE
laurance	FEMALE
lauranne	FEMALE
laure	FEMALE
laurean	FEMALE
laureanne	FEMALE
laureen	FEMALE
laurel	FEMALE
lauren	FEMALE
lauren	MALE
laurence	FEMALE
laurence	MALE
laurens	MALE
laurens-jan	MALE
laurense	FEMALE
laurent	MALE
laurentia	FEMALE
laurentius	MALE
laurenzia	FEMALE
lauressa	FEMALE
lauret	MALE
lauretta	FEMALE
laurette	FEMALE
lauri	MALE
laurian	FEMALE
laurian	MALE
laurianne	FEMALE
laurids	MALE
laurie	FEMALE
laurie	MALE
laurie-lee	FEMALE
laurien	FEMALE
laurina	FEMALE
laurinda	FEMALE
laurine	FEMALE
laurits	MALE
lauritz	MALE
lauryn	FEMALE
laurèl	FEMALE
laus	MALE
lauwerina	FEMALE
lavendel	FEMALE
lavina	FEMALE
lavinia	FEMALE
lavino	MALE
lavrans	MALE
lavéra	FEMALE
lawa	FEMALE
lawand	MALE
lawrence	MALE
layana	FEMALE
layla	FEMALE
laymon	MALE
layn	FEMALE
layn	MALE
lazare	MALE
lazlo	FEMALE
lazlo	MALE
laërtes	MALE
laïla	FEMALE
laïs	FEMALE
lea	FEMALE
leaellyn	FEMALE
leaf	MALE
leah	FEMALE
lean	MALE
leana	FEMALE
leander	MALE
leandra	FEMALE
leandro	MALE
leanette	FEMALE
leaniek	FEMALE
leann	FEMALE
leannah	FEMALE
leannan	FEMALE
leanne	FEMALE
lebora	FEMALE
leco	MALE
lecoli	FEMALE
led	MALE
leda	FEMALE
lee	FEMALE
lee	MALE
leechin	FEMALE
leen	FEMALE
leen	MALE
leena	FEMALE
leenard	MALE
leendert	MALE
leentje	FEMALE
leeroy	MALE
leetha	FEMALE
leeza	FEMALE
lefterry	MALE
legien	FEMALE
lei	FEMALE
lei	MALE
leia	FEMALE
leida	FEMALE
leidus	MALE
leier	MALE
leif	MALE
leigh	FEMALE
leigh	MALE
leighanne	FEMALE
leila	FEMALE
leilani	FEMALE
leile	FEMALE
leindert	MALE
leintje	FEMALE
leis	MALE
leisl	FEMALE
lejla	FEMALE
lele-kalle	MALE
lelia	FEMALE
leliane	FEMALE
lelie	FEMALE
lely	FEMALE
lemia	FEMALE
lemke	FEMALE
lemmy	MALE
lemuel	MALE
len	MALE
lena	FEMALE
lenard	MALE
lenchen	FEMALE
lencho	MALE
lencio	MALE
lene	FEMALE
lenette	FEMALE
lenhard	MALE
leni	FEMALE
lenie	FEMALE
lenina	FEMALE
lenja	FEMALE
lenka	FEMALE
lenn	MALE
lenna	FEMALE
lennaert	MALE
lennan	FEMALE
lennard	MALE
lennart	MALE
lenne	FEMALE
lenneke	FEMALE
lennert	MALE
lennie	FEMALE
lennie	MALE
lenno	MALE
lennon	MALE
lennox	MALE
lenny	FEMALE
lenny	MALE
lenora	FEMALE
lenore	FEMALE
lenta	FEMALE
lente	FEMALE
lentel	FEMALE
lentha	FEMALE
lenthe	FEMALE
leo	MALE
leoda	FEMALE
leola	FEMALE
leoma	FEMALE
leon	FEMALE
leon	MALE
leon-jacob	MALE
leona	FEMALE
leonard	MALE
leonarda	FEMALE
leonardo	MALE
leonardus	MALE
leonato	MALE
leone	FEMALE
leone	MALE
leonhard	MALE
leonhardt	MALE
leoni	FEMALE
leonid	MALE
leonidas	MALE
leonie	FEMALE
leoniek	FEMALE
leonieke	FEMALE
leonique	FEMALE
leonne	FEMALE
leonneke	FEMALE
leonnello	MALE
leonoor	FEMALE
leonor	FEMALE
leonora	FEMALE
leonore	FEMALE
leontien	FEMALE
leontiene	FEMALE
leontine	FEMALE
leopold	MALE
leopolda	FEMALE
leopoldina	FEMALE
leopoldine	FEMALE
leopoldo	MALE
leora	FEMALE
leota	FEMALE
lerang	MALE
leron	MALE
leroy	MALE
les	MALE
lescha	FEMALE
leska	FEMALE
lesley	FEMALE
lesley	MALE
leslie	FEMALE
leslie	MALE
lesly	MALE
lester	MALE
let	FEMALE
letice	FEMALE
leticia	FEMALE
letitia	FEMALE
letizia	FEMALE
letje	FEMALE
lette	FEMALE
lettie	FEMALE
letty	FEMALE
leukothea	FEMALE
leuni	FEMALE
leuqe	FEMALE
lev	MALE
levani	MALE
levi	MALE
leviande	FEMALE
levie	MALE
levien	FEMALE
levin	MALE
levina	FEMALE
levinio	MALE
levon	MALE
levonne	FEMALE
levy	MALE
lewis	MALE
lex	MALE
lexi	FEMALE
ley	MALE
leya	FEMALE
leyla	FEMALE
lia	FEMALE
liadan	FEMALE
liam	MALE
lian	FEMALE
liana	FEMALE
lianda	FEMALE
liandra	FEMALE
liane	FEMALE
lianka	FEMALE
lianne	FEMALE
lianneke	FEMALE
libbe	MALE
libby	FEMALE
liberty	FEMALE
libor	MALE
libuse	FEMALE
licenka	FEMALE
lichelie	FEMALE
lichell	FEMALE
lichella	FEMALE
lichelle	FEMALE
licia	FEMALE
liciana	FEMALE
lida	FEMALE
lidda	FEMALE
liddy	FEMALE
lide	FEMALE
lidewei	FEMALE
lidewij	FEMALE
lidia	FEMALE
lidian	FEMALE
lidiuska	FEMALE
lidovic	MALE
liduine	FEMALE
lidwien	FEMALE
lidwina	FEMALE
lidwine	FEMALE
lidy	FEMALE
lidy	MALE
lie	FEMALE
liedeke	FEMALE
liedewei	FEMALE
liedewij	FEMALE
liedy	FEMALE
liefke	FEMALE
lieja	FEMALE
liek	FEMALE
lieke	FEMALE
liel	FEMALE
lien	FEMALE
lienard	MALE
lieneke	FEMALE
lienke	FEMALE
lienna	FEMALE
lientje	FEMALE
lieo	MALE
lierroy	MALE
lies	FEMALE
liesa	FEMALE
liesamary	FEMALE
liesan	FEMALE
liesanne	FEMALE
liesbet	FEMALE
liesbeth	FEMALE
liese	FEMALE
liesel	FEMALE
lieseloortje	FEMALE
lieselore	FEMALE
lieselot	FEMALE
lieselotte	FEMALE
liesje	FEMALE
lieske	FEMALE
liet	MALE
lieteke	FEMALE
lieuwe	MALE
lieve	FEMALE
lieveke	FEMALE
lievemijn	FEMALE
lieven	MALE
lievijn	MALE
lieze	FEMALE
liezebet	FEMALE
lifia	FEMALE
ligaya	FEMALE
lijda	FEMALE
lijon	MALE
lijsbeth	FEMALE
lika	FEMALE
lil	FEMALE
lila	FEMALE
lilaya	FEMALE
lili	FEMALE
lilia	FEMALE
lilian	MALE
liliana	FEMALE
liliane	FEMALE
lilianne	FEMALE
lilith	FEMALE
lill	FEMALE
lillan	FEMALE
lillana	FEMALE
lillemor	FEMALE
lilli	FEMALE
lillian	FEMALE
lillianne	FEMALE
lilly	FEMALE
lilou	FEMALE
lily	FEMALE
lil’lynn	FEMALE
lil’lynn	FEMALE
lina	FEMALE
lincey	FEMALE
linchen	FEMALE
lincoln	MALE
lincy	FEMALE
linda	FEMALE
lindamin	FEMALE
linday	FEMALE
linde	FEMALE
lindert	MALE
lindessa	FEMALE
lindi	FEMALE
lindo	MALE
lindon	MALE
lindor	FEMALE
lindsay	FEMALE
lindsay	MALE
lindsey	FEMALE
lindy	FEMALE
line	FEMALE
linea	FEMALE
lineke	FEMALE
linette	FEMALE
linford	MALE
liniette	FEMALE
linn	FEMALE
linnea	FEMALE
linnebel	FEMALE
linny	FEMALE
lino	MALE
linos	MALE
linquenda	FEMALE
linsey	FEMALE
linsy	FEMALE
linus	MALE
linzi	FEMALE
linzy	FEMALE
lioba	FEMALE
lioch	FEMALE
lion	FEMALE
lion	MALE
liona	FEMALE
lionardo	MALE
lione	FEMALE
lionel	MALE
lionell	MALE
lionello	MALE
lionne	FEMALE
liora	FEMALE
lipbertus	MALE
lippo	MALE
lique	FEMALE
liquinda	FEMALE
liron	MALE
lisa	FEMALE
lisabet	FEMALE
lisabeth	FEMALE
lisalotte	FEMALE
lisan	FEMALE
lisandra	FEMALE
lisanne	FEMALE
lisbet	FEMALE
lisbeth	FEMALE
lischa	FEMALE
lise	FEMALE
liselore	FEMALE
liselot	FEMALE
liselotte	FEMALE
liselotte	FEMALE
lisen	FEMALE
lisenka	FEMALE
liset	FEMALE
lisetta	FEMALE
lisette	FEMALE
liske	FEMALE
lissa	FEMALE
lissana	FEMALE
lisse	FEMALE
lissy	FEMALE
lita	FEMALE
litse	MALE
liuwe	MALE
liv	FEMALE
livai	MALE
live	FEMALE
livette	FEMALE
livi	FEMALE
livia	FEMALE
livie	FEMALE
livine	FEMALE
livinia	FEMALE
livio	MALE
livius	MALE
livvi	FEMALE
liwon	MALE
liz	FEMALE
liza	FEMALE
lizalotje	FEMALE
lizan	FEMALE
lizanne	FEMALE
lize	FEMALE
lizette	FEMALE
lizi	FEMALE
lizia	FEMALE
lizl	FEMALE
lizz	FEMALE
lizzi	FEMALE
lizzy	FEMALE
lië	FEMALE
liël	FEMALE
ljubinka	FEMALE
llandor	MALE
lleighton	MALE
lleyton	MALE
lloyd	MALE
lo	MALE
loan	FEMALE
lobbe	MALE
lobi	FEMALE
lobke	FEMALE
localita	FEMALE
lode	MALE
lodewijk	MALE
lodewyck	MALE
lodne	FEMALE
lodovico	MALE
lody	MALE
loe	MALE
loef	MALE
loek	MALE
loeka	FEMALE
loeke	FEMALE
loeki	FEMALE
loekie	FEMALE
loena	FEMALE
loerte	FEMALE
loerte	MALE
loes	FEMALE
loesa	FEMALE
loesie	FEMALE
loesje	FEMALE
loeske	FEMALE
loet	MALE
logan	MALE
lohra	FEMALE
lohren	FEMALE
loina	FEMALE
lois	FEMALE
loise	FEMALE
lola	FEMALE
lolette	FEMALE
lolien	FEMALE
lolita	FEMALE
lolkje	FEMALE
lolo	FEMALE
loltje	FEMALE
lomme	MALE
lon	MALE
lonette	FEMALE
long	MALE
loni	FEMALE
lonie	FEMALE
lonieke	FEMALE
lonja	MALE
lonne	FEMALE
lonneke	FEMALE
lonnog	FEMALE
looi	MALE
loor	FEMALE
loore	FEMALE
lopke	FEMALE
lor	MALE
loraine	FEMALE
loran	FEMALE
loran	MALE
loranna	FEMALE
lorchen	FEMALE
lore	FEMALE
loredana	FEMALE
loreen	FEMALE
lorei	FEMALE
lorelei	FEMALE
lorelia	FEMALE
lorelie	FEMALE
lorella	FEMALE
loren	MALE
lorena	FEMALE
lorenne	FEMALE
lorenz	MALE
lorenza	FEMALE
lorenzo	MALE
loreto	MALE
loretta	FEMALE
lorette	FEMALE
lorie	FEMALE
lorien	FEMALE
lorin	FEMALE
lorinda	FEMALE
lorine	FEMALE
loris	MALE
lorisa	FEMALE
loritz	MALE
lorjelyn	FEMALE
lorraine	FEMALE
lot	FEMALE
loth	FEMALE
lothar	MALE
lotje	FEMALE
lotta	FEMALE
lottchen	FEMALE
lotte	FEMALE
lotteke	FEMALE
lottemieke	FEMALE
lotty	FEMALE
lotus	FEMALE
loty	FEMALE
lou	MALE
louanna	FEMALE
louanne	FEMALE
louca	MALE
loudi	FEMALE
louel	FEMALE
louelle	FEMALE
louhi	FEMALE
louis	MALE
louis-paul	MALE
louis-peter	MALE
louisa	FEMALE
louise	FEMALE
louisette	FEMALE
louiza	FEMALE
louk	MALE
louka	FEMALE
louke	FEMALE
loulou	FEMALE
loura	FEMALE
lourdes	FEMALE
lourens	MALE
lousewies	FEMALE
louter	FEMALE
louwrens	MALE
love	FEMALE
lovley	FEMALE
lowie	MALE
lowies	MALE
lowize	FEMALE
lowri	FEMALE
loy	MALE
loyiou	FEMALE
loys	FEMALE
loïc	MALE
loïs	FEMALE
luan	FEMALE
luana	FEMALE
luane	FEMALE
luara	FEMALE
lubbe	MALE
lubbert	MALE
lubette	FEMALE
lubke	FEMALE
lubkea	FEMALE
lubna	FEMALE
luc	MALE
luca	FEMALE
luca	MALE
lucan	MALE
lucas	MALE
lucca	FEMALE
luce	FEMALE
lucean	MALE
lucelle	FEMALE
lucero	FEMALE
lucette	FEMALE
luchino	MALE
lucho	MALE
lucia	FEMALE
lucian	MALE
luciana	FEMALE
luciane	FEMALE
lucianna	FEMALE
luciano	MALE
lucianus	MALE
lucie	FEMALE
lucien	MALE
lucienne	FEMALE
lucile	FEMALE
lucilia	FEMALE
lucilla	FEMALE
lucille	FEMALE
lucinda	FEMALE
lucio	MALE
lucita	FEMALE
lucius	MALE
luciënne	FEMALE
lucky	FEMALE
lucky	MALE
luco	MALE
lucretia	FEMALE
lucrezia	FEMALE
lucrezio	MALE
lucrisia	FEMALE
lucréce	FEMALE
lucy	FEMALE
lucyna	FEMALE
lude	MALE
ludger	MALE
ludianne	FEMALE
ludie	FEMALE
ludmila	FEMALE
ludmilla	FEMALE
ludo	MALE
ludolf	MALE
ludona	FEMALE
ludovic	MALE
ludovica	FEMALE
ludovicus	MALE
ludwica	FEMALE
ludwiene	FEMALE
ludwig	MALE
ludwina	FEMALE
lugach	FEMALE
luglio	MALE
luigi	MALE
luigino	MALE
luis	MALE
luisa	FEMALE
luise	FEMALE
luiseach	FEMALE
luit	MALE
luiza	FEMALE
luka	FEMALE
luka	MALE
lukas	MALE
lukas-pjotr	MALE
lukasz	MALE
luke	MALE
lukretia	FEMALE
lulo	MALE
lulu	FEMALE
lumke	FEMALE
lummie	FEMALE
lun	FEMALE
luna	FEMALE
lunaaa	FEMALE
lundert	MALE
lune	FEMALE
lungile	MALE
lunia	FEMALE
lupe	FEMALE
lupko	MALE
lurleen	FEMALE
lusanne	FEMALE
lusian	FEMALE
lut	FEMALE
luteijn	FEMALE
luteijn	MALE
lutgard	FEMALE
lutgarda	FEMALE
lutgarde	FEMALE
lutgardis	FEMALE
lutgart	FEMALE
lutger	MALE
lutgerdina	FEMALE
luther	MALE
luthera	FEMALE
lutje	FEMALE
lutsen	MALE
lutske	FEMALE
lutte	MALE
luuc	MALE
luuk	FEMALE
luuk	MALE
luuke	FEMALE
luus	FEMALE
luut	MALE
luutje	FEMALE
luva	FEMALE
luwana	FEMALE
luwanna	FEMALE
luwanne	FEMALE
luwe	MALE
luz	FEMALE
luzetta	FEMALE
luzia	FEMALE
luzie	FEMALE
ly	FEMALE
lyall	MALE
lyam	MALE
lyan	FEMALE
lyanca	FEMALE
lyang	FEMALE
lycke	FEMALE
lyckele	MALE
lyda	FEMALE
lydeke	FEMALE
lydia	FEMALE
lydian	FEMALE
lydianne	FEMALE
lydie	FEMALE
lyenna	FEMALE
lygia	FEMALE
lykele	MALE
lykha	FEMALE
lykle	MALE
lyle	MALE
lyndel	MALE
lynden	FEMALE
lyndsey	FEMALE
lynet	FEMALE
lynette	FEMALE
lynkeus	MALE
lynn	FEMALE
lynn	MALE
lynna	FEMALE
lynndell	MALE
lynne	FEMALE
lynnett	FEMALE
lynnia	FEMALE
lynsey	FEMALE
lynsie	FEMALE
lynsley	FEMALE
lyonne	FEMALE
lyra	FEMALE
lysa	FEMALE
lysander	MALE
lysandro	MALE
lysanna	FEMALE
lysanne	FEMALE
lysbert	FEMALE
lysbeth	FEMALE
lysette	FEMALE
lytha	FEMALE
lyzette	FEMALE
lászlo	MALE
lázár	MALE
lénick	FEMALE
léon	MALE
léonce	FEMALE
léone	FEMALE
léonie	FEMALE
lönika	MALE
löwe	MALE
lúthien	FEMALE
maagje	FEMALE
maaik	MALE
maaike	FEMALE
maaitje	FEMALE
maamke	FEMALE
maan	MALE
maaren	MALE
maaret	FEMALE
maaria	FEMALE
maarika	FEMALE
maarit	FEMALE
maarith	FEMALE
maarte	MALE
maarten	MALE
maarten-lan	MALE
maarten-thomas	MALE
maartine	FEMALE
maartje	FEMALE
maathijsje	FEMALE
maayke	FEMALE
mabel	FEMALE
mabelia	FEMALE
mabrun	MALE
mabèl	FEMALE
mace	MALE
macella	FEMALE
maceo	MALE
macey	FEMALE
macha	FEMALE
machael	MALE
machelien	FEMALE
machelina	FEMALE
machelle	FEMALE
machelt	FEMALE
machias	MALE
machiel	MALE
machion	MALE
machteld	FEMALE
machtelt	FEMALE
mack	MALE
mackenzie	MALE
macona	MALE
macualy	MALE
macy	FEMALE
maday	MALE
maddalena	FEMALE
maddie	FEMALE
maddonna	FEMALE
maddy	FEMALE
madelaine	FEMALE
madelan	FEMALE
madeleen	FEMALE
madelein	FEMALE
madeleine	FEMALE
madelena	FEMALE
madelief	FEMALE
madeliefje	FEMALE
madelien	FEMALE
madelientje	FEMALE
madelijn	FEMALE
madelijne	FEMALE
madeline	FEMALE
madelon	FEMALE
madelyne	FEMALE
madelène	FEMALE
madge	FEMALE
madhavee	FEMALE
madhu	MALE
madina	FEMALE
madison	FEMALE
madita	FEMALE
madleen	FEMALE
madlen	FEMALE
madonna	FEMALE
madou	FEMALE
mads	MALE
mady	FEMALE
madé	FEMALE
madée	FEMALE
mae	FEMALE
maen	FEMALE
maene	FEMALE
maerle	FEMALE
maerten	MALE
maes	MALE
maeté	FEMALE
maeve	FEMALE
maeyke	FEMALE
mafalda	FEMALE
mafalda	FEMALE
mafku	MALE
magali	FEMALE
magalie	FEMALE
magaly	FEMALE
magda	FEMALE
magdaleen	FEMALE
magdalen	FEMALE
magdalena	FEMALE
magdaline	FEMALE
magdeliet	FEMALE
magdelone	FEMALE
mage	FEMALE
mageritha	FEMALE
maggie	FEMALE
maggy	FEMALE
magiel	MALE
magli	FEMALE
magnhild	FEMALE
magnus	MALE
magreta	FEMALE
mahalia	FEMALE
mahen	MALE
maher	MALE
mahleen	FEMALE
mahmud	MALE
mahsa	FEMALE
mai	FEMALE
mai-lin	FEMALE
maia	FEMALE
maibritt	FEMALE
maichail	MALE
maickel	MALE
maico	MALE
maida	FEMALE
maigosha	FEMALE
maija	FEMALE
maik	MALE
maika	FEMALE
maike	FEMALE
maikel	MALE
maikey	MALE
maiko	MALE
maikol	MALE
mailen	FEMALE
maillanie	FEMALE
maille	FEMALE
mailo	MALE
maino	MALE
maion	FEMALE
maira	FEMALE
maire	FEMALE
mairead	FEMALE
mairin	FEMALE
mairona	FEMALE
mais	MALE
maita	FEMALE
maite	FEMALE
maité	FEMALE
maixent	MALE
maj	FEMALE
maja	FEMALE
majah	FEMALE
majanka	FEMALE
majate	FEMALE
majbritt	FEMALE
majda	FEMALE
majel	FEMALE
majelia	FEMALE
majid	MALE
majke	FEMALE
majken	FEMALE
majlen	FEMALE
majon	FEMALE
majorie	FEMALE
majorieke	FEMALE
majsa	FEMALE
makaje	FEMALE
maki	FEMALE
makien	FEMALE
mala	FEMALE
mala	FEMALE
malachy	MALE
malaika	FEMALE
malanka	FEMALE
malchen	FEMALE
maleen	FEMALE
malena	FEMALE
malene	FEMALE
malenge	FEMALE
malenka	FEMALE
malia	FEMALE
maliek	FEMALE
malien	FEMALE
malik	MALE
malika	FEMALE
malin	FEMALE
malina	FEMALE
malincha	FEMALE
malinda	FEMALE
malinka	FEMALE
malique	FEMALE
malissa	FEMALE
malkanthi	FEMALE
malliane	FEMALE
mallory	FEMALE
malone	FEMALE
malou	FEMALE
malouk	FEMALE
malouke	FEMALE
malte	MALE
malu	FEMALE
malu	FEMALE
malva	FEMALE
malvina	FEMALE
malvino	MALE
malya	FEMALE
mamdouh	MALE
mana	FEMALE
manar	FEMALE
manasse	MALE
manasta	FEMALE
mance	FEMALE
manda	FEMALE
mandisa	FEMALE
mandrask	MALE
mandus	MALE
mandy	FEMALE
mane	MALE
manel	FEMALE
manel	MALE
manelja	FEMALE
manfred	MALE
manfredo	MALE
mania	FEMALE
manik	FEMALE
manin	FEMALE
manique	FEMALE
manisha	FEMALE
manita	FEMALE
manja	FEMALE
manjana	FEMALE
manjek	MALE
manne	MALE
manno	MALE
mano	MALE
manoah	MALE
manoe	FEMALE
manoega	FEMALE
manoesch	FEMALE
manoeska	FEMALE
manola	FEMALE
manolda	FEMALE
manolito	MALE
manolo	MALE
manon	FEMALE
manonne	FEMALE
manori	FEMALE
manou	FEMALE
manou	MALE
manouk	FEMALE
manoushka	FEMALE
manta	FEMALE
mante	MALE
manten	MALE
manto	FEMALE
manu	MALE
manuel	MALE
manuela	FEMALE
manuele	MALE
manuella	FEMALE
manus	MALE
map	FEMALE
mar	FEMALE
mar	MALE
mar-luc	MALE
mara	FEMALE
marai	FEMALE
maraise	FEMALE
maral	FEMALE
maralyn	FEMALE
maran	FEMALE
maranatha	FEMALE
marandy	FEMALE
maranka	FEMALE
marc	MALE
marc-anthony	MALE
marc-kevin	MALE
marc-marie	MALE
marc-philip	MALE
marc-philippe	MALE
marcea	FEMALE
marceau	MALE
marcel	MALE
marcela	FEMALE
marcelia	FEMALE
marceliano	MALE
marcelie	FEMALE
marcelin	FEMALE
marcelina	FEMALE
marceline	FEMALE
marcelino	MALE
marcelis	MALE
marcella	FEMALE
marcellin	MALE
marcellina	FEMALE
marcellino	MALE
marcellinus	MALE
marcello	MALE
marcellus	MALE
marcelo	MALE
marcha	FEMALE
marcha	MALE
marchellito	MALE
marchetto	MALE
marchien	FEMALE
marchionne	MALE
marcia	FEMALE
marcia	FEMALE
marciano	MALE
marcin	MALE
marcio	MALE
marck	MALE
marco	MALE
marcon	MALE
marcos	MALE
marcus	MALE
mardien	FEMALE
mardieneke	FEMALE
mardon	MALE
mardou	FEMALE
mare	FEMALE
maree	FEMALE
mareen	FEMALE
marei	FEMALE
mareike	FEMALE
marein	MALE
marek	MALE
marelda	FEMALE
marell	FEMALE
marelle	FEMALE
maren	FEMALE
marene	FEMALE
marenka	FEMALE
marenne	FEMALE
mareno	MALE
marente	FEMALE
marenthe	FEMALE
maret	FEMALE
marete	FEMALE
marg	FEMALE
marga	FEMALE
margaret	FEMALE
margareta	FEMALE
margarete	FEMALE
margaretha	FEMALE
margaretta	FEMALE
margarita	FEMALE
margaritha	FEMALE
margaux	FEMALE
margereta	FEMALE
margery	FEMALE
margherita	FEMALE
margit	FEMALE
margitka	FEMALE
margitta	FEMALE
margje	FEMALE
margo	FEMALE
margot	FEMALE
margreet	FEMALE
margret	FEMALE
margrete	FEMALE
margriet	FEMALE
margrietha	FEMALE
margtje	FEMALE
marguerite	FEMALE
margurite	FEMALE
margy	FEMALE
mari	FEMALE
mari	MALE
maria	FEMALE
mariah	FEMALE
marialouise	FEMALE
mariam	FEMALE
mariama	FEMALE
marian	FEMALE
mariana	FEMALE
mariandel	FEMALE
marianela	FEMALE
marianella	FEMALE
marianka	FEMALE
marianna	FEMALE
marianne	FEMALE
marianneke	FEMALE
mariano	MALE
maribelle	FEMALE
maric	MALE
marica	FEMALE
marice	FEMALE
marick	MALE
marida	FEMALE
marie	FEMALE
mariek	FEMALE
marieka	FEMALE
marieke	FEMALE
marieken	FEMALE
mariel	FEMALE
mariele	FEMALE
marielena	FEMALE
marielia	FEMALE
marielie	FEMALE
mariella	FEMALE
marielle	FEMALE
marielouise	FEMALE
marien	MALE
mariena	FEMALE
mariene	FEMALE
mariet	FEMALE
marieta	FEMALE
marietje	FEMALE
marietta	FEMALE
mariette	FEMALE
marig	FEMALE
marigje	FEMALE
marihuela	FEMALE
marij	FEMALE
marija	FEMALE
marijcke	FEMALE
marije	FEMALE
marijke	FEMALE
marijn	FEMALE
marijn	MALE
marijne	FEMALE
marijntje	FEMALE
marijse	FEMALE
marijtje	FEMALE
marik	MALE
marika	FEMALE
marike	FEMALE
mariken	FEMALE
mariko	FEMALE
maril	FEMALE
marilee	FEMALE
marileen	FEMALE
marilene	FEMALE
mariliese	FEMALE
marilisa	FEMALE
marilotte	FEMALE
marilou	FEMALE
marilsa	FEMALE
marilva	FEMALE
marilyn	FEMALE
marin	FEMALE
marina	FEMALE
marinada	FEMALE
marinda	FEMALE
marinde	FEMALE
marinel	FEMALE
marinella	FEMALE
marinelle	FEMALE
marines	FEMALE
marinett	FEMALE
marinetta	FEMALE
marinka	FEMALE
marinke	FEMALE
marinko	MALE
marino	MALE
marinthe	FEMALE
marinus	MALE
mario	MALE
mariola	FEMALE
marioleine	FEMALE
marion	FEMALE
marion	MALE
mariona	FEMALE
marionna	FEMALE
marios	MALE
mariose	FEMALE
marique	FEMALE
maris	MALE
marisa	FEMALE
marisca	FEMALE
marise	FEMALE
marisha	FEMALE
marisja	FEMALE
mariska	FEMALE
marisohilan	FEMALE
marisol	FEMALE
marissa	FEMALE
marit	FEMALE
marita	FEMALE
marite	FEMALE
marith	FEMALE
maritha	FEMALE
maritte	FEMALE
marius	MALE
mariète	FEMALE
marja	FEMALE
marjam	FEMALE
marjan	FEMALE
marjanne	FEMALE
marjanneke	FEMALE
marjel	FEMALE
marjelia	FEMALE
marjella	FEMALE
marjen	FEMALE
marjenka	FEMALE
marjenke	FEMALE
marjet	FEMALE
marjetta	FEMALE
marjette	FEMALE
marjo	FEMALE
marjo	MALE
marjoke	FEMALE
marjolanda	FEMALE
marjolein	FEMALE
marjoleine	FEMALE
marjolien	FEMALE
marjolijn	FEMALE
marjolijne	FEMALE
marjon	FEMALE
marjona	FEMALE
marjorie	FEMALE
marjory	FEMALE
marjouska	FEMALE
mark	MALE
mark-paul	MALE
mark-pieter	MALE
mark-toine	MALE
marka	FEMALE
markelien	FEMALE
marko	MALE
markus	MALE
markward	MALE
marla	FEMALE
marlayne	FEMALE
marle	FEMALE
marleen	FEMALE
marlein	FEMALE
marleine	FEMALE
marlene	FEMALE
marleneke	FEMALE
marlenia	FEMALE
marley	FEMALE
marlie	FEMALE
marlieke	FEMALE
marlien	MALE
marlies	FEMALE
marlijn	FEMALE
marlijne	FEMALE
marlin	FEMALE
marlin	MALE
marlinda	FEMALE
marlinde	FEMALE
marlino	MALE
marlis	FEMALE
marlison	MALE
marlize	FEMALE
marlleen	FEMALE
marlo	MALE
marloes	FEMALE
marloet	FEMALE
marlon	MALE
marlot	FEMALE
marlotte	FEMALE
marlou	FEMALE
marlou	FEMALE
marlouk	FEMALE
marlouke	FEMALE
marlous	FEMALE
marly	FEMALE
marlyke	FEMALE
marlyn	FEMALE
marlynn	FEMALE
marne	MALE
marnel	FEMALE
marnick	MALE
marnie	FEMALE
marnik	MALE
marnin	FEMALE
marniq	MALE
marnix	MALE
maro	MALE
maroa	FEMALE
marody	FEMALE
maroesha	FEMALE
maroeska	FEMALE
maron	FEMALE
maros	MALE
maroucha	FEMALE
marouscha	FEMALE
marouschka	FEMALE
maroussia	FEMALE
marquad	MALE
marquerite	FEMALE
marquita	FEMALE
marre	FEMALE
marret	FEMALE
marretje	FEMALE
marrie	FEMALE
marrifem	FEMALE
marrin	MALE
marrit	FEMALE
marrus	MALE
marry	FEMALE
mars	MALE
marscha	FEMALE
marsela	FEMALE
marsha	FEMALE
marshall	MALE
mart	MALE
marta	FEMALE
martan	MALE
martay	FEMALE
marte	FEMALE
marten	MALE
marten jan	MALE
martenjob	MALE
martes	MALE
marteyn	FEMALE
marth	FEMALE
martha	FEMALE
marthe	FEMALE
marthijn	MALE
marthijs	MALE
marthus	MALE
marti	FEMALE
martial	MALE
martien	MALE
martientje	MALE
martijn	MALE
martijne	FEMALE
martijntje	FEMALE
martin	MALE
martina	FEMALE
martine	FEMALE
martinien	MALE
martino	MALE
martinus	MALE
martje	FEMALE
martjelieke	FEMALE
martyn	MALE
martzen	MALE
martón	MALE
maruja	FEMALE
marus	MALE
marvat	MALE
marvel	MALE
marvelino	MALE
marvin	MALE
marwin	MALE
marx	MALE
mary	FEMALE
maryam	FEMALE
marye	FEMALE
maryjet	FEMALE
maryke	FEMALE
maryl	FEMALE
marylana	FEMALE
marylene	FEMALE
marylon	FEMALE
marylou	FEMALE
maryn	FEMALE
maryn	MALE
maryon	FEMALE
maryono	MALE
maryse	FEMALE
marysha	FEMALE
marysol	FEMALE
maryvonne	FEMALE
marzella	FEMALE
marèl	FEMALE
marèns	FEMALE
maría	FEMALE
mas	MALE
masahiko	MALE
masaya	MALE
mascha	FEMALE
maschinka	FEMALE
masha	FEMALE
masira	FEMALE
masja	FEMALE
maske	FEMALE
masny	FEMALE
mason	MALE
masselina	FEMALE
massimiano	MALE
massimiliano	MALE
massimo	MALE
master	MALE
matan	FEMALE
matan	MALE
matanja	FEMALE
matein	MALE
mateo	MALE
mathe	MALE
matheo	MALE
mathew	MALE
mathias	MALE
mathieu	MALE
mathijs	MALE
mathilda	FEMALE
mathilde	FEMALE
mathis	MALE
mathiss	MALE
mathisse	MALE
mathon	MALE
mathuw	MALE
mathyn	MALE
mathys	MALE
mathé	MALE
matica	FEMALE
matijn	MALE
matilda	FEMALE
matilde	FEMALE
matis	MALE
matisse	MALE
matiz	MALE
matkel	MALE
mats	MALE
matse	MALE
matt	MALE
mattanja	FEMALE
matte	MALE
matteo	MALE
mattes	MALE
matthea	FEMALE
mattheus	MALE
matthew	MALE
matthias	MALE
matthieuw	MALE
matthijs	MALE
matthio	MALE
matthis	MALE
matti	MALE
mattie	FEMALE
mattina	FEMALE
mattya	FEMALE
mattyn	MALE
maty	FEMALE
matys	MALE
matz	MALE
maud	FEMALE
maudie	FEMALE
maudy	FEMALE
mauk	MALE
maup	MALE
maura	FEMALE
mauranne	FEMALE
maureen	FEMALE
mauri	MALE
mauric	MALE
maurice	MALE
mauricette	FEMALE
mauricio	MALE
maurick	MALE
maurie	FEMALE
maurien	FEMALE
maurijn	MALE
maurik	MALE
maurilla	FEMALE
maurillio	MALE
maurinus	MALE
maurise	FEMALE
mauritio	MALE
mauritius	MALE
maurits	MALE
maurizio	MALE
maurizzio	MALE
mauro	MALE
maury	FEMALE
maury	MALE
maus	FEMALE
maut	MALE
mauve	FEMALE
mavis	FEMALE
max	MALE
maxa	FEMALE
maxe	FEMALE
maxi	FEMALE
maxim	MALE
maxima	FEMALE
maxime	FEMALE
maximiliaan	MALE
maximilian	MALE
maximo	MALE
maximus	MALE
maxine	FEMALE
maxuel	MALE
maxuelle	MALE
maxwell	MALE
maxx	MALE
may	FEMALE
maya	FEMALE
maya	FEMALE
mayah	FEMALE
mayah	MALE
mayaserana	FEMALE
maybelline	FEMALE
maybritt	FEMALE
mayca	FEMALE
mayce	FEMALE
maydi	FEMALE
mayela	FEMALE
mayka	FEMALE
mayke	FEMALE
maykel	MALE
mayla	FEMALE
maylen	FEMALE
maylinn	FEMALE
mayon	FEMALE
mayra	FEMALE
mayro	MALE
mayva	FEMALE
mazarine	FEMALE
maël	MALE
maïte	FEMALE
maïté	FEMALE
mckenzie	FEMALE
mea	FEMALE
mead	MALE
meagan	FEMALE
meagen	FEMALE
meaghan	FEMALE
meanda	FEMALE
meander	FEMALE
meau	FEMALE
mecca	FEMALE
mechel	FEMALE
mecheline	FEMALE
mechiel	MALE
mechteld	FEMALE
mechthild	FEMALE
mechthilde	FEMALE
mechtild	FEMALE
mecx	MALE
medan	MALE
medardo	MALE
meden	FEMALE
medi	MALE
medoesa	FEMALE
medoon	MALE
medusa	FEMALE
medy	FEMALE
meef	MALE
meehna	FEMALE
meen	FEMALE
meenard	MALE
meerie	FEMALE
meerke	FEMALE
meertinus	MALE
meertjuh	FEMALE
mees	MALE
meeuwis	MALE
meeyah	FEMALE
meg	FEMALE
megan	FEMALE
megareus	MALE
meggie	FEMALE
megin	MALE
mehdy	MALE
mei	FEMALE
meia	FEMALE
meie	MALE
meije	MALE
meijke	FEMALE
meika	FEMALE
meike	FEMALE
meile	MALE
meilla	FEMALE
meillia	FEMALE
meilsje	FEMALE
meina	FEMALE
meindert	MALE
meine	MALE
meinert	MALE
meinhard	MALE
meinke	FEMALE
meinnilla	FEMALE
meintsje	FEMALE
meis	MALE
meiz	FEMALE
mela	FEMALE
melancka	FEMALE
melania	FEMALE
melanie	FEMALE
melati	FEMALE
melattie	FEMALE
melcher	MALE
melchior	MALE
melchiora	FEMALE
melchiore	MALE
mele	FEMALE
melek	FEMALE
melenie	FEMALE
melfrin	MALE
melger	MALE
melgior	MALE
melgor	MALE
melia	FEMALE
melian	MALE
melih	MALE
melina	FEMALE
melinda	FEMALE
meline	FEMALE
melinka	FEMALE
melis	FEMALE
melisa	FEMALE
melisaa	FEMALE
melisande	FEMALE
melissa	FEMALE
melissamarye	FEMALE
melissatje	FEMALE
melisse	FEMALE
melitia	FEMALE
melitta	FEMALE
meliya	FEMALE
melker	MALE
melkior	MALE
mell	FEMALE
mella	FEMALE
mellany	FEMALE
melle	MALE
melli	FEMALE
mellis	MALE
melodie	FEMALE
melody	FEMALE
melonie	FEMALE
melora	FEMALE
melphie	FEMALE
melpomene	FEMALE
melrone	MALE
mels	MALE
meltem	FEMALE
melville	MALE
melvin	MALE
melvina	FEMALE
melvyn	MALE
melwin	MALE
melza	FEMALE
mena	FEMALE
menahem	MALE
menasse	MALE
menda	FEMALE
mendel	MALE
mendela	FEMALE
mendi	FEMALE
mendie	FEMALE
mendior	MALE
mendo	MALE
mendy	FEMALE
menelaos	MALE
menghua	FEMALE
menico	MALE
menke	FEMALE
menna	FEMALE
menne	MALE
mennie	MALE
menno	MALE
menny	FEMALE
menoikeus	MALE
mensje	FEMALE
menso	MALE
menthe	FEMALE
mentje	FEMALE
mentoor	MALE
menw	FEMALE
menya	FEMALE
menzel	MALE
meo	MALE
mequo	MALE
meral	FEMALE
meraly	FEMALE
mercator	MALE
mercede	FEMALE
mercedes	FEMALE
mercy	FEMALE
meredith	FEMALE
mereke	FEMALE
merel	FEMALE
merete	FEMALE
mergen	MALE
mergje	FEMALE
meriam	FEMALE
merie	FEMALE
meriel	FEMALE
merije	FEMALE
merijn	FEMALE
merijnen	MALE
merik	MALE
merin	FEMALE
merissa	FEMALE
merit	FEMALE
merith	FEMALE
meriyntje	FEMALE
merja	FEMALE
merla	FEMALE
merle	FEMALE
merle	MALE
merleau	MALE
merlijn	FEMALE
merlijn	MALE
merlijne	FEMALE
merlin	MALE
merlina	FEMALE
merlissa	FEMALE
merope	FEMALE
merove	FEMALE
merquin	MALE
merrick	MALE
merrit	FEMALE
merthein	MALE
merthijn	MALE
mertijn	MALE
merva	FEMALE
merveille	FEMALE
mervin	MALE
mervyn	MALE
mervyne	FEMALE
meryl	FEMALE
meryt	FEMALE
mesach	MALE
messina	FEMALE
meta	FEMALE
metha	FEMALE
metin	MALE
metje	FEMALE
metodio	MALE
metta	FEMALE
mette	FEMALE
mette	MALE
metteke	FEMALE
metten	MALE
mettina	FEMALE
meve	FEMALE
mew	MALE
mex	MALE
mexx	MALE
meyke	FEMALE
meyns	MALE
meyrick	MALE
meze	MALE
mi jin	FEMALE
mia	FEMALE
miakla	FEMALE
mian	FEMALE
miao	FEMALE
miao	MALE
miarleen	FEMALE
mica	FEMALE
micaela	FEMALE
micah	FEMALE
micha	MALE
michael	MALE
michael-anthony	MALE
michael-thomas	MALE
michaela	FEMALE
michal	FEMALE
michal	MALE
michal-stanislav	MALE
michala	FEMALE
michali	FEMALE
michanne	FEMALE
michar	MALE
michaël	MALE
michaëla	FEMALE
michel	MALE
michel-angelo	MALE
michela	FEMALE
michelangelo	MALE
michele	MALE
michelie	FEMALE
micheline	FEMALE
michella	FEMALE
michelle	FEMALE
michey	FEMALE
michiel	MALE
michio	MALE
michon	FEMALE
michou	FEMALE
michèle	FEMALE
mick	MALE
mickael	MALE
mickel	MALE
mickey	FEMALE
micky	FEMALE
micky	MALE
micol	FEMALE
midas	MALE
midge	MALE
mido	MALE
midori	FEMALE
mie	FEMALE
miebeth	FEMALE
mieke	FEMALE
miel	MALE
miels	MALE
mien	FEMALE
mieneke	FEMALE
mienke	FEMALE
miens	MALE
miente	MALE
mientje	FEMALE
miep	FEMALE
mierla	FEMALE
mies	FEMALE
mies	MALE
miesa	FEMALE
miesje	FEMALE
miet	FEMALE
miets	FEMALE
mietta	FEMALE
migaita	MALE
migel	MALE
mignon	FEMALE
mignonne	FEMALE
migueia	FEMALE
miguel	MALE
miguela	FEMALE
mihaela	FEMALE
mihai	MALE
mihaila	FEMALE
miia	FEMALE
mija	FEMALE
mije	FEMALE
mijke	FEMALE
mijntje	FEMALE
mijs	FEMALE
mik	MALE
mika	FEMALE
mika	MALE
mikael	MALE
mikaela	FEMALE
mikal	MALE
mikala	FEMALE
mikaya	FEMALE
mikayla	FEMALE
mike	MALE
mikeasa	FEMALE
mikel	MALE
mikey	MALE
mikhail	MALE
miki	FEMALE
mikkel	MALE
mikkel	MALE
mikki	FEMALE
mikkie	MALE
mikkiel	MALE
miklas	MALE
miklos	MALE
miko	FEMALE
mil	MALE
mila	FEMALE
milada	FEMALE
milaja	FEMALE
milan	MALE
milana	FEMALE
milangelo	MALE
milas	MALE
milco	MALE
mildred	FEMALE
mile	MALE
mileen	FEMALE
milena	FEMALE
milenka	FEMALE
miles	MALE
miliaan	MALE
miliam	MALE
milian	FEMALE
milian	MALE
milica	FEMALE
milicia	FEMALE
milie	FEMALE
milika	FEMALE
milina	FEMALE
milja	FEMALE
milka	FEMALE
milla	FEMALE
millard	MALE
millicent	FEMALE
millie	FEMALE
millo	MALE
millow	MALE
milly	FEMALE
milo	MALE
miloe	FEMALE
milos	MALE
milosz	MALE
milou	FEMALE
milou	FEMALE
milton	MALE
miluska	FEMALE
milva	FEMALE
mimi	FEMALE
mina	FEMALE
minakshi	FEMALE
minchen	FEMALE
minda	FEMALE
minde	FEMALE
mindert	MALE
mindou	FEMALE
mindy	FEMALE
mine	FEMALE
mineke	FEMALE
minella	FEMALE
minem	FEMALE
minerva	FEMALE
minervina	FEMALE
minesya	FEMALE
minetta	FEMALE
minette	FEMALE
ming	MALE
mingo	MALE
mingus	MALE
minja	FEMALE
mink	MALE
minka	FEMALE
minke	FEMALE
minkel	FEMALE
minna	FEMALE
minnatullah	FEMALE
minne	FEMALE
minnie	FEMALE
mino	MALE
minoesch	FEMALE
minoesh	FEMALE
minor	MALE
minos	MALE
minou	FEMALE
minouche	FEMALE
minouk	FEMALE
minouka	FEMALE
minouschka	FEMALE
minta	FEMALE
minte	FEMALE
minto	MALE
minton	MALE
minze	MALE
mione	FEMALE
miqueli	MALE
miquell	MALE
mira	FEMALE
mirabel	FEMALE
mirabelia	FEMALE
mirabell	FEMALE
mirabella	FEMALE
mirabelle	FEMALE
mirada	FEMALE
miralda	FEMALE
miranda	FEMALE
miranka	FEMALE
mirca	FEMALE
mirec	MALE
mireille	FEMALE
mirel	FEMALE
mirela	FEMALE
mirelda	FEMALE
mirelia	FEMALE
mirella	FEMALE
mirelle	FEMALE
mirena	FEMALE
mirenne	FEMALE
mirette	FEMALE
mirha	FEMALE
miriam	FEMALE
mirian	FEMALE
mirieme	FEMALE
mirinda	FEMALE
mirja	FEMALE
mirjam	FEMALE
mirjan	FEMALE
mirjana	FEMALE
mirjon	FEMALE
mirk	MALE
mirka	FEMALE
mirkaza	FEMALE
mirkaza	MALE
mirle	FEMALE
mirli	FEMALE
mirna	FEMALE
mirne	FEMALE
miro	MALE
mirola	FEMALE
miron	MALE
mironne	FEMALE
miroslava	FEMALE
mirre	FEMALE
mirron	FEMALE
mirsad	MALE
mirta	FEMALE
mirte	FEMALE
mirtha	FEMALE
mirthe	FEMALE
mirvet	FEMALE
miryana	FEMALE
miryanne	FEMALE
miryea	FEMALE
mirèse	FEMALE
miró	MALE
misa	FEMALE
misael	MALE
mischa	FEMALE
mischa	MALE
mischou	FEMALE
misha	FEMALE
mishel	MALE
mishounaira	FEMALE
misia	FEMALE
misja	FEMALE
misja	MALE
miska	MALE
missy	FEMALE
mistafa	MALE
misthy	FEMALE
misty	FEMALE
mitch	MALE
mitchel	FEMALE
mitchel	MALE
mitchell	MALE
mitra	FEMALE
mitrei	MALE
mitsah	MALE
mitte	FEMALE
mitzy	FEMALE
mixiam	MALE
mladen	MALE
mo	FEMALE
moan	FEMALE
modeste	MALE
mody	FEMALE
moena	FEMALE
moene	MALE
moesa	MALE
moetie	FEMALE
moevy	FEMALE
mogens	MALE
moheddine	MALE
moi	FEMALE
moira	FEMALE
moirin	FEMALE
moirès	MALE
moisa	FEMALE
moisha	FEMALE
moko	FEMALE
molina	FEMALE
molly	FEMALE
mon	MALE
mona	FEMALE
monalisa	FEMALE
moncha	FEMALE
monchi	MALE
mone	FEMALE
monetta	FEMALE
mong	MALE
mongfind	FEMALE
moni	FEMALE
monica	FEMALE
moniek	FEMALE
monika	FEMALE
moniqe	FEMALE
monique	FEMALE
monita	FEMALE
monja	FEMALE
monse	FEMALE
montse	FEMALE
montserrat	FEMALE
monty	MALE
mony	FEMALE
moo	FEMALE
moon	FEMALE
moonray	MALE
moor	MALE
moortje	FEMALE
moos	MALE
mor	FEMALE
mora	FEMALE
morayma	FEMALE
morciano	MALE
mordechai	MALE
moreeke	FEMALE
morena	FEMALE
moreno	MALE
morenzio	MALE
moretto	MALE
morfeus	MALE
morgaine	FEMALE
morgan	FEMALE
morgan	MALE
morgana	FEMALE
moriah	FEMALE
morillo	MALE
moritz	MALE
morqiana	FEMALE
morris	MALE
morrisey	MALE
morten	MALE
morten	MALE
morton	MALE
moshe	MALE
moshen	MALE
mostapha	MALE
moteil	MALE
mouna	FEMALE
mounya	FEMALE
mourad	MALE
moustafa	MALE
mout	MALE
moyca	FEMALE
mozes	MALE
moësha	FEMALE
moïsa	FEMALE
moïse	FEMALE
moïsha	FEMALE
mrabet	MALE
muadhnait	FEMALE
muadnat	FEMALE
mugain	FEMALE
muireacht	FEMALE
muireann	FEMALE
muirgel	FEMALE
muirgheal	FEMALE
muirin	FEMALE
muiriol	FEMALE
muirne	FEMALE
muith	MALE
murat	MALE
mureal	FEMALE
murelle	FEMALE
muriel	FEMALE
murielie	FEMALE
murillo	MALE
muriël	FEMALE
muriëlle	FEMALE
murk	MALE
murphy	MALE
murray	MALE
murron	FEMALE
mus	FEMALE
musetta	FEMALE
mustafa	MALE
mustapha	MALE
mutaya	FEMALE
muus	FEMALE
muus	MALE
mya	FEMALE
mychon	FEMALE
myella	FEMALE
myelle	FEMALE
myishi	MALE
myke	FEMALE
mykon	MALE
myla	FEMALE
mylan	FEMALE
mylene	FEMALE
mylenka	FEMALE
mylo	MALE
mylon	MALE
mylou	FEMALE
mynthe	FEMALE
myntje	FEMALE
myon	FEMALE
myora	FEMALE
myra	FEMALE
myralijn	FEMALE
myran	MALE
myranda	FEMALE
myrena	FEMALE
myriam	FEMALE
myriame	FEMALE
myrian	FEMALE
myrie	FEMALE
myrka	FEMALE
myrna	FEMALE
myrne	FEMALE
myron	MALE
myronne	FEMALE
myrron	MALE
myrte	FEMALE
myrtha	FEMALE
myrthe	FEMALE
myrtilos	MALE
mythe	FEMALE
médard	MALE
mélisande	FEMALE
mésach	MALE
móric	MALE
müleyke	FEMALE
naama	FEMALE
naan	FEMALE
naara	FEMALE
naard	MALE
naarsie	MALE
naas	MALE
nabila	FEMALE
nabor	MALE
naboth	MALE
nacavenly	FEMALE
nada	FEMALE
nadah	FEMALE
nadalina	FEMALE
naddy	FEMALE
nadeche	FEMALE
nadette	FEMALE
nadezhda	FEMALE
nadi	FEMALE
nadia	FEMALE
nadieh	FEMALE
nadien	FEMALE
nadih	FEMALE
nadina	FEMALE
nadine	FEMALE
nadinka	FEMALE
nadir	MALE
nadira	FEMALE
nadire	FEMALE
nadisha	FEMALE
nadja	FEMALE
nadjeschda	FEMALE
nadma	FEMALE
nady	FEMALE
nadysha	FEMALE
nadège	FEMALE
naema	FEMALE
nafiesa	FEMALE
nafiessou	MALE
naftali	MALE
naftoli	MALE
naguy	MALE
nahid	FEMALE
nahnya	FEMALE
nahrenjo	MALE
naiad	FEMALE
naijra	FEMALE
naike	FEMALE
naila	FEMALE
naila	MALE
nailah	FEMALE
naima	FEMALE
najade	FEMALE
najate	FEMALE
najda	FEMALE
najesca	FEMALE
najil	MALE
najim	MALE
nakita	FEMALE
nakkyana	FEMALE
nakïa	FEMALE
nala	FEMALE
nalaani	FEMALE
naldo	MALE
naline	FEMALE
nalini	FEMALE
nalinie	FEMALE
nalle	MALE
namara	FEMALE
namia	FEMALE
namna	FEMALE
nan	MALE
nana	FEMALE
nance	FEMALE
nancy	FEMALE
nand	MALE
nanda	FEMALE
nande	FEMALE
nandels	FEMALE
nander	MALE
nandi	FEMALE
nandita	FEMALE
nando	MALE
nandus	MALE
nandy	MALE
nane	FEMALE
nanet	FEMALE
nanette	FEMALE
nani	FEMALE
nanie	FEMALE
naniek	FEMALE
nanieke	FEMALE
nanine	FEMALE
nanique	FEMALE
nanja	FEMALE
nanna	FEMALE
nanne	FEMALE
nanne	MALE
nanneke	FEMALE
nannerl	FEMALE
nannette	FEMALE
nanni	FEMALE
nannie	FEMALE
nanno	MALE
nanoescha	FEMALE
nanon	FEMALE
nanou	FEMALE
nanouck	MALE
nanouk	FEMALE
naomi	FEMALE
naomy	FEMALE
nap	MALE
napoleon	MALE
napoleone	MALE
naqui	FEMALE
nara	FEMALE
narada	MALE
naradi	MALE
naranga	FEMALE
narbhla	FEMALE
narcisse	FEMALE
nard	MALE
narda	FEMALE
nardeesha	FEMALE
nardi	MALE
nardine	FEMALE
nardo	MALE
nardus	MALE
narena	FEMALE
naret	FEMALE
narinah	FEMALE
narisha	FEMALE
naro	MALE
narrel	FEMALE
nas	MALE
nash	MALE
nasra	FEMALE
nasrin	FEMALE
nastasja	FEMALE
nastenka	FEMALE
nastjenka	FEMALE
nat	MALE
nata	FEMALE
natale	FEMALE
natalia	FEMALE
natalie	FEMALE
natalina	FEMALE
natalja	FEMALE
natalya	FEMALE
natalé	FEMALE
natanja	FEMALE
natanya	FEMALE
natascha	FEMALE
natasha	FEMALE
natasia	FEMALE
natasja	FEMALE
natassja	FEMALE
nate	MALE
natelie	FEMALE
natesja	FEMALE
nathalia	FEMALE
nathalie	FEMALE
nathalja	FEMALE
nathaly	FEMALE
nathalya	FEMALE
nathan	MALE
nathaniel	MALE
nathascha	FEMALE
nathely	FEMALE
nati	FEMALE
natosha	FEMALE
nats	FEMALE
natunia	FEMALE
naud	MALE
naudin	MALE
nauka	FEMALE
nausikaä	FEMALE
naut	MALE
navaho	MALE
navarone	MALE
nawa	FEMALE
nawal	FEMALE
nawfal	MALE
nawiella	FEMALE
nayka	FEMALE
nazar	MALE
nazia	FEMALE
nazifa	FEMALE
nazira	FEMALE
nazreen	FEMALE
nazzaro	MALE
naära	FEMALE
naëlle	FEMALE
naëma	FEMALE
naïri	FEMALE
ndidi	FEMALE
nea	FEMALE
neal	MALE
neamhain	FEMALE
neapoleone	MALE
necha	FEMALE
ned	MALE
neel	MALE
neeldert	MALE
neelke	MALE
neelt	MALE
neeltje	FEMALE
neeske	FEMALE
nefele	FEMALE
neha	FEMALE
neiah	FEMALE
neil	MALE
neisa	FEMALE
nel	FEMALE
nelab	FEMALE
nelda	FEMALE
nele	FEMALE
nele	MALE
neleno	MALE
nelia	FEMALE
nelie	FEMALE
neliene	FEMALE
neline	FEMALE
nelis	MALE
nelisa	FEMALE
nelissa	FEMALE
nelke	FEMALE
nell	FEMALE
nella	FEMALE
nelle	MALE
nelleke	FEMALE
nelli	FEMALE
nelly	FEMALE
nelson	MALE
nemel	FEMALE
nemo	MALE
nena	FEMALE
nenda	FEMALE
neneh	FEMALE
nenette	FEMALE
nenno	MALE
neo	MALE
neobe	FEMALE
neomi	FEMALE
neomie	FEMALE
neoptolemos	MALE
nereus	MALE
nerine	FEMALE
nerissa	FEMALE
nermina	FEMALE
nero	MALE
nesely	FEMALE
ness	FEMALE
nessa	FEMALE
nessaya	FEMALE
nessie	FEMALE
nessos	MALE
nesta	MALE
nesta	MALE
nestoor	MALE
nestor	MALE
netta	FEMALE
nettchen	FEMALE
nette	FEMALE
netti	FEMALE
nettie	FEMALE
netty	FEMALE
neve	FEMALE
nevil	MALE
nevin	FEMALE
nevin	MALE
nevine	FEMALE
nezha	FEMALE
neziha	FEMALE
ngadia	FEMALE
nia	FEMALE
niall	MALE
niamara	FEMALE
niamh	FEMALE
nian	FEMALE
nianca	FEMALE
nianne	FEMALE
nica	FEMALE
nicah	FEMALE
nichelle	FEMALE
nicho	MALE
nicholas	MALE
nick	MALE
nickel	MALE
nicki	FEMALE
nickki	FEMALE
nickolas	MALE
nicky	FEMALE
nicky	MALE
niclaa	FEMALE
nico	MALE
nicodemus	MALE
nicola	MALE
nicolaas	MALE
nicolaes	MALE
nicolai	MALE
nicolas	MALE
nicolas	MALE
nicolaus	MALE
nicole	FEMALE
nicoletta	FEMALE
nicolette	FEMALE
nicolien	FEMALE
nicolina	FEMALE
nicoline	FEMALE
nicolino	MALE
nicolle	FEMALE
nicolo	MALE
nicoltje	FEMALE
nicolás	MALE
nidia	FEMALE
niek	MALE
nieke	FEMALE
niekus	MALE
nieky	FEMALE
niel	MALE
niels	MALE
nielsine	FEMALE
nielt	FEMALE
nienke	FEMALE
nientje	FEMALE
niesje	FEMALE
nieske	FEMALE
nigel	MALE
nihaila	FEMALE
nihan	FEMALE
nijobi	FEMALE
nijs	MALE
nik	MALE
nika	FEMALE
nikai	MALE
nikander	MALE
nikay	FEMALE
nikee	FEMALE
niki	FEMALE
nikie	FEMALE
nikita	FEMALE
nikita	MALE
nikki	FEMALE
nikkley	FEMALE
nikky	FEMALE
niklas	MALE
niko	MALE
nikolai	MALE
nikolaj	MALE
nikolas	MALE
nikoletta	FEMALE
nikolien	FEMALE
nikoline	FEMALE
nikos	MALE
nikta	FEMALE
nila	FEMALE
nilaya	FEMALE
nilda	FEMALE
nille	MALE
nilles	MALE
nilofar	FEMALE
nils	MALE
nima	FEMALE
nimae	FEMALE
nimfa	FEMALE
nimke	FEMALE
nimrod	MALE
nimue	FEMALE
nimuë	FEMALE
nimwue	FEMALE
nina	FEMALE
ninah	FEMALE
nine	FEMALE
nineth	FEMALE
ninette	FEMALE
niniane	FEMALE
ninieck	FEMALE
ninja	FEMALE
ninka	FEMALE
ninke	FEMALE
ninna	FEMALE
nino	MALE
ninon	FEMALE
ninotchka	FEMALE
ninuska	FEMALE
ninée	FEMALE
niobe	FEMALE
nioh	MALE
niomie	FEMALE
niovice	FEMALE
nique	FEMALE
niquelle	FEMALE
nirphania	FEMALE
nirvana	FEMALE
nis	MALE
nisha	FEMALE
niska	FEMALE
nisrine	FEMALE
nissa	FEMALE
nisse	MALE
nissir	MALE
nissy	FEMALE
nita	FEMALE
nithin	MALE
nitin	MALE
niva	FEMALE
nivard	MALE
nixie	FEMALE
niyara	FEMALE
njonja	FEMALE
no results: the dapp ran, but did not find any matching results in the given url.no results: the dapp ran, but did not find any matching results in the given url.faantje	FEMALE
noa	FEMALE
noach	MALE
noah	MALE
noam	MALE
noazette	FEMALE
noble	MALE
noco	MALE
noddy	MALE
noe	MALE
noeke	FEMALE
noeki	FEMALE
noeki	FEMALE
noel	MALE
noelie	FEMALE
noelie	FEMALE
noell	FEMALE
noell	FEMALE
noella	FEMALE
noella	FEMALE
noelle	FEMALE
noelle	FEMALE
noemi	FEMALE
noemi	FEMALE
noemie	FEMALE
noemie	FEMALE
noeran	FEMALE
noeran	FEMALE
noeri	FEMALE
noeri	FEMALE
noes	FEMALE
noes	FEMALE
noeschka	FEMALE
noeschka	FEMALE
noeshin	FEMALE
noeshin	FEMALE
noesja	FEMALE
noesja	FEMALE
noia	FEMALE
noia	FEMALE
noie	MALE
nol	MALE
nolan	MALE
nold	MALE
nolda	FEMALE
noldus	MALE
nolien	FEMALE
nolle	MALE
nomad	MALE
nomi	FEMALE
nomie	FEMALE
non	FEMALE
nona	FEMALE
nonie	FEMALE
nonja	FEMALE
nono	FEMALE
nonèz	FEMALE
noor	FEMALE
noortje	FEMALE
nopales	MALE
nora	FEMALE
norah	FEMALE
noraly	FEMALE
norbert	MALE
norberta	FEMALE
norberte	FEMALE
norbertha	FEMALE
norberthe	FEMALE
nordica	FEMALE
nordin	MALE
nordine	FEMALE
nore	FEMALE
noreen	FEMALE
noriaki	MALE
norik	MALE
norina	FEMALE
norina	FEMALE
norine	FEMALE
norio	MALE
norma	FEMALE
norman	MALE
normen	MALE
norn	FEMALE
norris	MALE
nort	MALE
norwin	MALE
nory	FEMALE
nosmo	MALE
noud	MALE
nouk	FEMALE
nouki	FEMALE
noumea	FEMALE
noura	FEMALE
nouran	MALE
nourdin	MALE
noureddine	MALE
nouredine	MALE
nouri	MALE
nourian	MALE
noury	MALE
nouska	FEMALE
nout	MALE
nova	FEMALE
novalee	FEMALE
novar	FEMALE
novc	FEMALE
nove	FEMALE
novia	FEMALE
nowa	FEMALE
nowelle	FEMALE
noémi	FEMALE
noémi	FEMALE
noë	FEMALE
noël	MALE
noëlle	FEMALE
noëlle	FEMALE
noëmina	FEMALE
noëmina	FEMALE
nuala	FEMALE
nucha	FEMALE
nuela	FEMALE
nunciaredish	FEMALE
nunzio	MALE
nuquyel	MALE
nura	FEMALE
nuray	FEMALE
nurettin	MALE
nuri	MALE
nuria	FEMALE
nurja	FEMALE
nurlaila	FEMALE
nuéva	FEMALE
nyah	FEMALE
nykle	MALE
nyla	FEMALE
nylo	MALE
nymfa	FEMALE
nymfe	FEMALE
nymph	FEMALE
nynke	FEMALE
nys	MALE
nysa	MALE
oabel	MALE
oaberam	MALE
oabram	MALE
oadam	MALE
oaderjaan	MALE
oagje	MALE
oalderk	MALE
oalf	MALE
oame	MALE
oamel	MALE
oamela	FEMALE
oane	MALE
oaries	MALE
oarnd	MALE
obbe	MALE
obbo	MALE
obdi	FEMALE
obe	MALE
oberon	MALE
octave	MALE
octavia	FEMALE
octavie	FEMALE
octavio	MALE
octavus	MALE
océane	FEMALE
oda	FEMALE
oddlaug	FEMALE
oddo	MALE
oddone	MALE
ode	MALE
oded	FEMALE
odeke	FEMALE
odelinde	FEMALE
odeon	MALE
odette	FEMALE
odiel	MALE
odile	FEMALE
odilia	FEMALE
odilon	MALE
odin	MALE
odina	FEMALE
odine	FEMALE
odion	MALE
odmar	MALE
odo	MALE
odorata	FEMALE
oduif	MALE
oeda	FEMALE
oeds	MALE
oege	MALE
oek	MALE
oeke	FEMALE
oekie	FEMALE
oele	MALE
oene	MALE
oenie	FEMALE
oerania	FEMALE
oet	FEMALE
oeteke	FEMALE
ofek	MALE
ofelia	FEMALE
ofori	MALE
ofra	FEMALE
ofure	FEMALE
oger	MALE
ogier	MALE
ohiersa	FEMALE
oichert	MALE
oink	FEMALE
oink	MALE
ok	FEMALE
okke	MALE
okkie	FEMALE
okko	MALE
oktavio	MALE
ola	FEMALE
olaf	MALE
olafine	FEMALE
olav	MALE
olava	FEMALE
olave	FEMALE
olda	FEMALE
olderico	MALE
olderik	MALE
oldrik	MALE
ole	MALE
olea	FEMALE
olena	FEMALE
olette	FEMALE
olf	MALE
olferd	MALE
olga	FEMALE
olger	MALE
olin	FEMALE
olinda	FEMALE
olindo	MALE
oline	FEMALE
olinka	FEMALE
olisha	FEMALE
oliva	FEMALE
olive	FEMALE
oliver	MALE
olivia	FEMALE
olivier	MALE
oliviero	MALE
ollie	FEMALE
olliefred	MALE
olly	FEMALE
olmo	MALE
olof	MALE
olov	MALE
olrik	MALE
oluf	MALE
olufine	FEMALE
olus	MALE
olva	FEMALE
olvin	MALE
olwen	FEMALE
olympia	FEMALE
olympie	FEMALE
omaima	FEMALE
omaira	FEMALE
omar	MALE
omario	MALE
omayra	FEMALE
omer	MALE
omero	MALE
omfale	FEMALE
omnia	FEMALE
ona	FEMALE
ondine	FEMALE
ondra	FEMALE
one	MALE
oneisha	FEMALE
onfredo	MALE
onida	FEMALE
onix	FEMALE
onko	MALE
onne	MALE
onno	MALE
onnoline	FEMALE
onofre	MALE
onora	FEMALE
onorata	FEMALE
onorato	MALE
onoria	FEMALE
onorio	MALE
oola	FEMALE
oole	MALE
oolke	FEMALE
oona	FEMALE
oonagh	FEMALE
opal	FEMALE
ophelia	FEMALE
ophir	MALE
oprah	FEMALE
orane	FEMALE
orania	FEMALE
orazio	MALE
orchid	FEMALE
orchidee	FEMALE
orcun	MALE
orestes	MALE
orfeus	MALE
orfhlaith	FEMALE
orhan	MALE
oriana	FEMALE
oriella	FEMALE
orin	MALE
oriol	MALE
orjan	MALE
orla	FEMALE
orlaith	FEMALE
orlanda	FEMALE
orlande	FEMALE
orlando	MALE
orlie	FEMALE
orly	FEMALE
orly	MALE
orma	FEMALE
orna	FEMALE
ornan	MALE
ornella	FEMALE
orpa	FEMALE
orrin	MALE
orsil	FEMALE
orsina	FEMALE
orsine	FEMALE
orso	MALE
orsola	FEMALE
orsolya	FEMALE
orson	MALE
ortelia	FEMALE
ortensia	FEMALE
ortwin	MALE
orva	FEMALE
oscar	MALE
ose	FEMALE
oskar	MALE
ossip	MALE
oswald	MALE
oswin	MALE
otello	MALE
othello	MALE
othniel	MALE
othon	MALE
otis	MALE
otje	FEMALE
otman	MALE
otmar	MALE
ottavi	MALE
otte	FEMALE
ottelien	FEMALE
otteline	FEMALE
otthella	FEMALE
otti	FEMALE
ottilia	FEMALE
ottilie	FEMALE
otto	MALE
ottofried	MALE
ottorinus	MALE
ouarda	FEMALE
ougust	MALE
ouke	MALE
oukje	FEMALE
ouwe	MALE
ouwert	MALE
ovide	MALE
ovidius	MALE
owain	MALE
owen	MALE
oxana	FEMALE
oz	MALE
ozlem	FEMALE
ozzy	MALE
paabio	MALE
paavo	MALE
pablo	MALE
pacelle	FEMALE
pacey	MALE
pacifico	MALE
paco	MALE
paddy	FEMALE
paddy	MALE
padmé	FEMALE
padraig	MALE
pagan	FEMALE
paige	FEMALE
paigen	FEMALE
palle	MALE
palma	FEMALE
palmeré	MALE
palmier	FEMALE
palmira	FEMALE
palmiro	MALE
palmo	MALE
palmyra	FEMALE
paloma	FEMALE
pam	FEMALE
pamela	FEMALE
pamelina	FEMALE
pamila	FEMALE
pamina	FEMALE
paméla	FEMALE
pancha	FEMALE
panchita	FEMALE
pancho	MALE
pancras	MALE
pandora	FEMALE
panter	FEMALE
paoio	MALE
paola	FEMALE
paoline	FEMALE
paolino	MALE
paolo	MALE
paquita	FEMALE
paquito	MALE
parcifal	MALE
pardis	FEMALE
parel	FEMALE
parella	FEMALE
parfait	MALE
parfen	MALE
pari	FEMALE
paris	MALE
parisa	FEMALE
parker	MALE
parrel	FEMALE
parwesh	MALE
parys	FEMALE
pascal	MALE
pascale	FEMALE
pascaline	FEMALE
pascalle	FEMALE
pascallire	FEMALE
paschalis	MALE
pascoe	MALE
pascual	MALE
paskal	MALE
pasquale	FEMALE
pasquale	MALE
pasqualina	FEMALE
pasqualine	FEMALE
pasqualino	MALE
pasqualle	FEMALE
passchier	MALE
pat	FEMALE
pat	MALE
patchaï	MALE
pato	MALE
patric	MALE
patrice	FEMALE
patrice	MALE
patrich	MALE
patricia	FEMALE
patricio	MALE
patricius	MALE
patrick	MALE
patrique	MALE
patriz	MALE
patrizia	FEMALE
patrizio	MALE
patroklos	MALE
patsy	FEMALE
pattickin	MALE
patty	FEMALE
patwin	MALE
pau	MALE
pauke	MALE
paul	MALE
paula	FEMALE
paule	FEMALE
pauleen	FEMALE
pauletta	FEMALE
paulette	FEMALE
paulie	FEMALE
paulien	FEMALE
paulin	MALE
paulina	FEMALE
pauline	FEMALE
paulisca	FEMALE
paulo	MALE
paulus	MALE
pauwel	MALE
pavan	MALE
pavel	MALE
pavla	FEMALE
pavlik	MALE
pavlos	MALE
pawla	FEMALE
pax	MALE
pearl	FEMALE
pebbles	FEMALE
pecko	MALE
peder	MALE
pedro	MALE
peele	MALE
peep	MALE
peer	MALE
peerke	MALE
peet	MALE
peetie	FEMALE
peetie	MALE
pegah	FEMALE
peggy	FEMALE
peiter	MALE
pekka	MALE
pelagie	FEMALE
pelayo	MALE
peleus	MALE
pelias	MALE
pelie	MALE
pelitha	FEMALE
pelle	MALE
pelops	MALE
pembe	FEMALE
pen	FEMALE
pen	FEMALE
penelope	FEMALE
penina	FEMALE
penney	FEMALE
penny	FEMALE
penthesileia	FEMALE
pepe	MALE
pepi	FEMALE
pepi	MALE
pepijn	MALE
pepita	FEMALE
pepito	MALE
peppe	MALE
peppo	MALE
pepsi	FEMALE
pepyn	MALE
percy	MALE
peregrino	MALE
perez	MALE
perihan	FEMALE
perijn	MALE
perisch	MALE
perla	FEMALE
perna	FEMALE
pernelia	FEMALE
pernella	FEMALE
pernette	FEMALE
pernilla	FEMALE
pernille	FEMALE
perpetua	FEMALE
perretta	FEMALE
perrin	FEMALE
perrin	MALE
perrine	FEMALE
perry	MALE
perré	MALE
perseus	MALE
pertonilla	FEMALE
pervin	FEMALE
perwina	FEMALE
perzik	FEMALE
peter	MALE
petertje	FEMALE
petey	MALE
petina	FEMALE
petr	FEMALE
petr	MALE
petra	FEMALE
petraschka	FEMALE
petrelle	FEMALE
petrelli	FEMALE
petri	FEMALE
petrie	MALE
petrine	FEMALE
petroeska	FEMALE
petronella	FEMALE
petronet	FEMALE
petronilia	FEMALE
petrus	MALE
petruschka	FEMALE
petula	FEMALE
pety	FEMALE
peyton	MALE
phaedra	FEMALE
pheadra	FEMALE
phebe	FEMALE
pheline	FEMALE
phemie	FEMALE
pheodora	FEMALE
phiala	FEMALE
phiebe	MALE
phil	MALE
phileine	FEMALE
philemon	MALE
philibert	MALE
philine	FEMALE
philip	MALE
philippa	FEMALE
philippe	FEMALE
philippe	MALE
philippina	FEMALE
philippine	FEMALE
phillis	FEMALE
philma	FEMALE
philomeen	FEMALE
philomela	FEMALE
philomele	FEMALE
philomena	FEMALE
philomene	FEMALE
phinchen	FEMALE
phine	FEMALE
phineas	MALE
phiti	FEMALE
phlox	FEMALE
phoebe	FEMALE
phoebel	FEMALE
phoenix	FEMALE
phylicia	FEMALE
phyllis	FEMALE
phyllisia	FEMALE
pia	FEMALE
pico	MALE
pie	MALE
piebe	MALE
pien	FEMALE
piene	FEMALE
pienk	FEMALE
pier	MALE
piera	FEMALE
pierce	MALE
pierette	FEMALE
pierguido	MALE
pierina	FEMALE
pierino	MALE
pierluigi	MALE
piero	MALE
piero	MALE
pierre	MALE
pierrent	MALE
piet	MALE
pieta	FEMALE
pieteke	FEMALE
pieter	MALE
pieterdina	FEMALE
pieterjan	MALE
pieterke	FEMALE
pieternel	FEMALE
pieternele	FEMALE
pieternella	FEMALE
pietje	FEMALE
pietrio	MALE
pietro	MALE
pijke	MALE
pike	MALE
pilar	FEMALE
pim	MALE
pimmie	FEMALE
pinky	FEMALE
pinou	FEMALE
pio	MALE
pip	FEMALE
pipa	FEMALE
piper	FEMALE
pippa	FEMALE
pippi	FEMALE
pippy	FEMALE
pirmin	MALE
pirmo	MALE
piroschka	FEMALE
piroska	FEMALE
pito	MALE
pittheus	MALE
pius	MALE
pjotr	MALE
placido	MALE
plaskoe	MALE
plato	MALE
pleun	FEMALE
pleuni	FEMALE
pleunie	FEMALE
ploni	FEMALE
plontjie	FEMALE
plontjie	MALE
plony	FEMALE
poekelien	FEMALE
poepie	FEMALE
pol	MALE
poldi	FEMALE
poldo	MALE
polina	FEMALE
polleke	MALE
pollo	MALE
polly	FEMALE
polo	MALE
polybos	MALE
polydoor	MALE
polyfemos	MALE
polyhymnia	FEMALE
pom	FEMALE
pomme	FEMALE
pommelien	FEMALE
pompeo	MALE
pontiaan	MALE
pontos	MALE
popco	MALE
popje	FEMALE
popkje	FEMALE
poppe	MALE
poppes	MALE
porgy	MALE
porshia	FEMALE
pou	MALE
poul	MALE
poula	FEMALE
poultje	FEMALE
poultje	MALE
poulus	MALE
poupia	FEMALE
pouw	MALE
pouwel	MALE
povel	MALE
powers	MALE
praba	FEMALE
preben	MALE
precilia	FEMALE
precious	FEMALE
preeya	FEMALE
prego	MALE
prekket	MALE
prem	MALE
premnath	MALE
prescilla	FEMALE
preu	FEMALE
preziosa	FEMALE
priamos	MALE
priantha	FEMALE
pricilla	FEMALE
pride	MALE
prieja	FEMALE
prim	MALE
primcha	MALE
primo	MALE
primus	MALE
prince	MALE
prior	MALE
prisca	FEMALE
priscella	FEMALE
priscilia	FEMALE
priscilla	FEMALE
priska	FEMALE
prispèr	MALE
prissilla	FEMALE
priszilla	FEMALE
priya	FEMALE
pro	MALE
prosper	MALE
proteus	MALE
prudence	FEMALE
prudens	MALE
prue	FEMALE
prunella	FEMALE
puck	FEMALE
puck	MALE
puella	FEMALE
puer	MALE
puk	FEMALE
pukki	FEMALE
pum	FEMALE
pumpy	MALE
punky	FEMALE
purcy	MALE
purdey	FEMALE
purrel	MALE
pybe	MALE
pylades	MALE
pyrra	FEMALE
pyt	MALE
pythia	FEMALE
péronne	FEMALE
qian	FEMALE
qruun	MALE
qu	FEMALE
quandey	MALE
quando	MALE
quardany	MALE
quasimodo	MALE
quchalin	FEMALE
qudesty	FEMALE
qudo	MALE
queen	FEMALE
queena	FEMALE
queenie	FEMALE
queeno	FEMALE
queeny	FEMALE
quelly	FEMALE
quentin	MALE
quentyn	FEMALE
querida	FEMALE
querijn	MALE
querine	FEMALE
quiana	FEMALE
quiane	FEMALE
quico	MALE
quido	MALE
quigley	MALE
quijahn	MALE
quin	MALE
quinc	FEMALE
quinc	MALE
quince	MALE
quincent	MALE
quincente	FEMALE
quincey	FEMALE
quincy	FEMALE
quincy	MALE
quindeus	MALE
quinella	FEMALE
quinelle	FEMALE
quinenta	FEMALE
quineta	FEMALE
quinlan	MALE
quinn	MALE
quino	MALE
quint	MALE
quint-jan	MALE
quinta	FEMALE
quintana	FEMALE
quintane	FEMALE
quinte	MALE
quinten	MALE
quintes	MALE
quintien	MALE
quintijn	MALE
quintilianus	MALE
quintillus	MALE
quintin	MALE
quintina	FEMALE
quintine	FEMALE
quinto	MALE
quinton	MALE
quintus	MALE
quinty	FEMALE
quinzjel	MALE
quiran	MALE
quireyn	FEMALE
quirien	FEMALE
quirien	MALE
quirientje	FEMALE
quirijn	MALE
quirijna	FEMALE
quirijne	FEMALE
quirina	FEMALE
quirine	FEMALE
quirino	MALE
quirinus	MALE
quiryna	FEMALE
quiryne	FEMALE
quislaine	FEMALE
quita	FEMALE
qulindaa	FEMALE
qun	FEMALE
quyen	FEMALE
qwen	FEMALE
qwendoline	FEMALE
qwendolyn	FEMALE
qyelle	FEMALE
raafke	MALE
raas	MALE
rabia	FEMALE
rachani	FEMALE
rachel	FEMALE
rachel	FEMALE
rachele	FEMALE
rachelie	FEMALE
rachella	FEMALE
rachelle	FEMALE
rachem	FEMALE
rachid	MALE
rachienne	FEMALE
rachil	FEMALE
rachna	FEMALE
rachne	FEMALE
rachèl	FEMALE
racqèl	FEMALE
radan	MALE
radaroen	MALE
radboud	MALE
rade	MALE
radhu	MALE
radia	FEMALE
radj	MALE
radjen	MALE
radjino	MALE
radjoe	MALE
radka	FEMALE
radmer	MALE
radmila	FEMALE
radmilla	FEMALE
radna	FEMALE
radolf	MALE
radomila	FEMALE
radoslav	MALE
radovan	MALE
raema	FEMALE
raf	MALE
rafael	MALE
rafaela	FEMALE
rafaelia	FEMALE
rafaella	FEMALE
rafaello	MALE
rafaelo	MALE
rafaël	MALE
raffaela	FEMALE
raffaella	FEMALE
raffaelo	MALE
raffica	FEMALE
raffick	MALE
raffie	MALE
raffiek	MALE
rafi	MALE
rafiq	MALE
rafke	FEMALE
ragdy	MALE
ragna	FEMALE
ragnar	MALE
ragnfrid	FEMALE
ragnhild	FEMALE
ragnvald	MALE
ragonda	FEMALE
rahel	FEMALE
rahied	MALE
rahmon	MALE
rahul	MALE
raico	MALE
raiesh	MALE
raiko	MALE
raimond	MALE
raimonda	FEMALE
raimondo	MALE
raimund	MALE
raimunde	FEMALE
raimundo	MALE
rain	MALE
raina	FEMALE
rainaldo	MALE
raine	FEMALE
rainer	MALE
rainier	MALE
rainy	MALE
raisa	FEMALE
raiza	FEMALE
rajco	MALE
raldy	FEMALE
ralf	MALE
ralph	MALE
ram	MALE
rama	FEMALE
rambaldo	MALE
rambert	MALE
rambo	MALE
rami	MALE
ramin	MALE
ramino	MALE
ramira	FEMALE
ramiro	MALE
ramon	MALE
ramona	FEMALE
ramonda	FEMALE
ramses	MALE
ramson	MALE
ramyar	MALE
ramzi	MALE
ramón	MALE
rana	FEMALE
ranait	FEMALE
ranalt	FEMALE
ranan	MALE
randa	FEMALE
randall	MALE
randi	FEMALE
randie	FEMALE
randolf	MALE
randolph	MALE
randy	MALE
rane	FEMALE
ranec	MALE
rangel	MALE
rani	FEMALE
rania	FEMALE
ranita	FEMALE
ranjan	MALE
rankar	FEMALE
rankon	MALE
ranni	MALE
ransom	MALE
ranya	FEMALE
raony	MALE
raoul	MALE
raph	MALE
raphael	MALE
raphaela	FEMALE
raphaele	FEMALE
raquel	FEMALE
rasa	FEMALE
rashelle	FEMALE
rashid	MALE
rashida	FEMALE
rashilla	FEMALE
rashlin	FEMALE
rasia	FEMALE
rasmus	MALE
rathnait	FEMALE
ratna	FEMALE
raul	MALE
raun	MALE
ravael	MALE
ravaldo	MALE
raven	FEMALE
ravenna	FEMALE
ravi	MALE
ravie	FEMALE
ravina	FEMALE
raviv	MALE
rawien	MALE
ray	MALE
rayira	FEMALE
rayline	FEMALE
raylison	MALE
raymi	MALE
raymon	MALE
raymond	MALE
raymonda	FEMALE
raymonde	FEMALE
rayn	MALE
rayna	FEMALE
raynaud	MALE
rayvano	MALE
rayven	FEMALE
rayèn	MALE
raza	FEMALE
razia	FEMALE
raïs	FEMALE
raïssa	FEMALE
rea	FEMALE
reamon	MALE
rebecca	FEMALE
rebekka	FEMALE
recano	MALE
recha	FEMALE
rechella	FEMALE
red	MALE
redlef	MALE
redmar	MALE
redney	MALE
reduan	MALE
reece	MALE
reemt	MALE
reese	FEMALE
refia	FEMALE
refke	FEMALE
reggie	FEMALE
reggie	MALE
reggy	MALE
regien	FEMALE
regiene	FEMALE
regina	FEMALE
reginald	MALE
reginaldo	MALE
regine	FEMALE
regner	MALE
regula	FEMALE
regy	MALE
rehana	FEMALE
reid	MALE
reider	MALE
reidun	FEMALE
reigherd	MALE
reijer	MALE
reilly	FEMALE
reimborg	FEMALE
reimer	MALE
reimon	MALE
rein	MALE
reina	FEMALE
reinaard	MALE
reinaert	MALE
reinald	MALE
reinalda	FEMALE
reinate	FEMALE
reinbert	MALE
reinder	MALE
reindert	MALE
reine	FEMALE
reineke	FEMALE
reiner	MALE
reinetta	FEMALE
reinette	FEMALE
reinhard	MALE
reinhoud	MALE
reinieke	FEMALE
reinier	MALE
reiniera	FEMALE
reink	MALE
reinko	MALE
reino	MALE
reinold	MALE
reinou	FEMALE
reinoud	MALE
reinout	MALE
reinskjen	FEMALE
reint	MALE
reiny	FEMALE
reist	MALE
reitse	MALE
reja	FEMALE
reka	FEMALE
rekina	FEMALE
relie	FEMALE
relinda	FEMALE
relinde	FEMALE
relindis	FEMALE
relusv	MALE
rembrandt	MALE
remco	MALE
remi	FEMALE
remi	MALE
remidius	MALE
remie	FEMALE
remies	MALE
remigio	MALE
remigius	MALE
remke	FEMALE
remkes	MALE
remma	FEMALE
remme	MALE
remmelt	MALE
remmert	MALE
remmet	MALE
remo	MALE
remon	MALE
remond	MALE
remondo	MALE
remy	FEMALE
remy	MALE
remya	FEMALE
ren	MALE
rena	FEMALE
renaat	MALE
renalda	FEMALE
renaldo	MALE
renard	MALE
renardo	MALE
renata	FEMALE
renate	FEMALE
renato	MALE
renatus	MALE
renaud	MALE
renco	MALE
rende	FEMALE
rendelina	FEMALE
rendy	MALE
rene	MALE
renee	FEMALE
renesta	FEMALE
reni	FEMALE
renier	MALE
reniet	MALE
renighel	MALE
renira	FEMALE
renke	MALE
rennee	FEMALE
rennie	MALE
renny	MALE
reno	MALE
rens	MALE
rense	MALE
renske	FEMALE
renuka	FEMALE
renze	MALE
renzo	MALE
rené	MALE
renée	FEMALE
reon	MALE
resa	FEMALE
reseda	FEMALE
reselle	FEMALE
reshma	FEMALE
resianne	FEMALE
residosio	MALE
resie	FEMALE
resy	FEMALE
reszö	MALE
rett	MALE
reugene	MALE
reurik	MALE
reva	MALE
revathi	FEMALE
reve	FEMALE
reve	MALE
rex	MALE
rexanna	FEMALE
rexanne	FEMALE
rey	MALE
reyca	FEMALE
reyer	MALE
reynaldo	MALE
reynier	MALE
reyno	MALE
reza	FEMALE
rezan	MALE
rezso	MALE
rezá	FEMALE
rhandy	MALE
rhazel	MALE
rhea	FEMALE
rheandro	MALE
rhino	MALE
rhoda	FEMALE
rhodan	MALE
rhode	FEMALE
rhodee	FEMALE
rhona	FEMALE
rhonda	FEMALE
rhune	MALE
rhûne	FEMALE
ria	FEMALE
riaaz	MALE
rian	FEMALE
rian	MALE
rianda	FEMALE
rianka	FEMALE
rianna	FEMALE
rianne	FEMALE
riborg	FEMALE
ric	MALE
rica	FEMALE
ricarda	FEMALE
ricardo	MALE
ricburg	FEMALE
riccarda	FEMALE
riccardo	MALE
ricco	MALE
richard	MALE
richarda	FEMALE
richardis	MALE
richel	MALE
richelia	FEMALE
richella	FEMALE
richelle	FEMALE
richellethy	FEMALE
richelly	FEMALE
richie	MALE
richte	MALE
richtsje	FEMALE
rick	MALE
rickard	MALE
rickert	MALE
ricket	MALE
rickey	FEMALE
rickey	MALE
rickie	FEMALE
ricky	FEMALE
ricky	MALE
rico	MALE
ridder	MALE
ridge	MALE
ridley	MALE
ridolfo	MALE
rieckie	FEMALE
riek	FEMALE
riek	MALE
rieka	FEMALE
rieke	FEMALE
riekele	FEMALE
riekelt	MALE
riekie	FEMALE
riekje	FEMALE
rielie	FEMALE
riemco	MALE
rieme	MALE
riemer	MALE
riemke	FEMALE
riemy	FEMALE
rien	MALE
riena	FEMALE
riender	MALE
rieneke	FEMALE
rienie	FEMALE
rienier	MALE
rienk	MALE
rienke	MALE
rienki	MALE
rienko	MALE
rient	MALE
rients	MALE
rienzo	MALE
ries	MALE
riet	FEMALE
riete	FEMALE
rieteke	FEMALE
rietje	FEMALE
riette	FEMALE
riewert	MALE
rifka	FEMALE
rigborg	FEMALE
rigobert	MALE
rigt	FEMALE
rigter	MALE
rijk	MALE
rijntje	FEMALE
rik	MALE
rika	FEMALE
rikard	MALE
rikchen	FEMALE
rike	FEMALE
riki	FEMALE
rikke	MALE
rikkert	MALE
rikki	FEMALE
rikki	MALE
rikkie	FEMALE
rikkie	MALE
rikolf	MALE
rikolv	MALE
riks	MALE
rikse	FEMALE
rikst	FEMALE
rikstje	FEMALE
rikus	MALE
rilana	FEMALE
riley	MALE
rilla	FEMALE
rille	FEMALE
rillette	FEMALE
rimkje	FEMALE
rimmert	MALE
rimski	MALE
rina	FEMALE
rinaldo	MALE
rinaldo	MALE
rinda	FEMALE
rindert	MALE
rindje	MALE
rineke	FEMALE
rinelle	FEMALE
ringo	MALE
rini	FEMALE
rinie	MALE
rinke	FEMALE
rinke	MALE
rinna	FEMALE
rino	MALE
rinoa	FEMALE
rinquette	FEMALE
rinse	MALE
rinske	FEMALE
rinskje	FEMALE
rint	MALE
rinus	MALE
riny	MALE
rinze	MALE
rio	MALE
rioghnach	FEMALE
riona	FEMALE
rionaldo	MALE
riordon	MALE
ris	FEMALE
risa	FEMALE
rishma	FEMALE
rishmi	FEMALE
riska	FEMALE
rissa	FEMALE
risto	MALE
rita	FEMALE
ritagna	FEMALE
ritchie	MALE
riteke	FEMALE
ritger	MALE
rithbertus	MALE
ritsaard	MALE
ritsaart	MALE
ritsart	MALE
ritske	FEMALE
ritske	MALE
riva	MALE
rivano	MALE
river	MALE
rivka	FEMALE
rivkah	FEMALE
rivlinho	MALE
riwanja	FEMALE
rixt	FEMALE
rixta	FEMALE
rixte	FEMALE
riza	FEMALE
rizzle	MALE
rizzo	FEMALE
riëlla	FEMALE
riëtta	FEMALE
riëtte	FEMALE
ro	FEMALE
roald	MALE
roan	MALE
roanco	MALE
roanna	FEMALE
roanne	FEMALE
roar	MALE
roarke	MALE
rob	MALE
robair	MALE
robbe	MALE
robbert	MALE
robbertina	FEMALE
robbie	MALE
robbin	MALE
robby	MALE
robbyn	FEMALE
roben	FEMALE
robert	MALE
roberta	FEMALE
roberte	FEMALE
robertien	FEMALE
robertina	FEMALE
robertino	MALE
roberto	MALE
robertus	MALE
robi	FEMALE
robijn	FEMALE
robin	FEMALE
robin	MALE
robina	FEMALE
robine	FEMALE
robrecht	MALE
robur	MALE
roby	FEMALE
robyn	FEMALE
rocco	MALE
roch	MALE
rochard	MALE
roche	MALE
rochelie	FEMALE
rochella	FEMALE
rochelle	FEMALE
rochshana	FEMALE
rochus	MALE
rocio	FEMALE
rock	MALE
rocket	MALE
rocky	MALE
rodante	FEMALE
rodas	MALE
roddie	FEMALE
roddy	FEMALE
roderi	MALE
roderica	FEMALE
roderick	MALE
rodericka	FEMALE
rodewald	MALE
rodey	FEMALE
rodge	MALE
rodger	MALE
rodi	MALE
rodin	MALE
rodmer	MALE
rodney	MALE
rodny	MALE
rodolfo	MALE
rodolphe	MALE
rodrigo	MALE
rodrigue	MALE
rodriguez	MALE
rodrique	MALE
rodwald	MALE
rody	FEMALE
rody	MALE
roeh	FEMALE
roel	MALE
roeland	MALE
roelanda	FEMALE
roelande	FEMALE
roelf	MALE
roelfien	FEMALE
roelfina	FEMALE
roeli	FEMALE
roelie	FEMALE
roelien	FEMALE
roelinda	FEMALE
roeline	FEMALE
roelinka	FEMALE
roelke	FEMALE
roelle	FEMALE
roelod	MALE
roelof	MALE
roelofina	FEMALE
roeltje	FEMALE
roely	FEMALE
roemer	MALE
roemi	MALE
roene	MALE
roey	MALE
rofayda	FEMALE
roge	MALE
roger	MALE
rogier	MALE
rogue	FEMALE
rohan	MALE
roike	FEMALE
roike	MALE
roimán	MALE
rois	FEMALE
roisin	FEMALE
rola	FEMALE
rolan	MALE
roland	MALE
rolanda	FEMALE
rolande	FEMALE
rolando	MALE
roldán	MALE
rolf	MALE
rolfo	MALE
rolieke	FEMALE
rolien	FEMALE
rolin	MALE
rolina	FEMALE
rolinda	FEMALE
rolinde	FEMALE
roline	FEMALE
rolinka	FEMALE
rolland	MALE
rolls	MALE
roma	FEMALE
romain	MALE
romaine	FEMALE
roman	MALE
romana	FEMALE
romanie	FEMALE
romano	MALE
romanus	MALE
romany	FEMALE
romar	MALE
romaric	MALE
romario	MALE
rombert	MALE
rombout	MALE
romeck	MALE
romee	FEMALE
romek	MALE
romelinda	FEMALE
romeny	FEMALE
romeo	MALE
romer	FEMALE
romhilda	FEMALE
romhilde	FEMALE
romi	FEMALE
romie	FEMALE
romie	MALE
romijn	FEMALE
romilda	FEMALE
romilde	FEMALE
romina	FEMALE
romio	MALE
romke	MALE
romkje	FEMALE
rommert	MALE
rommie	FEMALE
romona	FEMALE
romuald	MALE
romulado	MALE
romy	FEMALE
romy-ann	FEMALE
romée	FEMALE
ron	MALE
rona	FEMALE
ronait	FEMALE
ronak	FEMALE
ronal	MALE
ronald	MALE
ronalda	FEMALE
ronalde	FEMALE
ronan	MALE
ronat	FEMALE
ronen	MALE
roni	MALE
ronika	FEMALE
ronin	MALE
ronit	FEMALE
ronja	FEMALE
ronmar	MALE
ronnart	MALE
ronnay	MALE
ronneke	FEMALE
ronnie	FEMALE
ronnie	MALE
ronny	FEMALE
rony	MALE
ronéll	FEMALE
roobin	FEMALE
rooney	MALE
roos	FEMALE
roosje	FEMALE
rooske	FEMALE
roosmarie	FEMALE
roosmarijn	FEMALE
rop	MALE
roppe	MALE
roque	MALE
rory	MALE
rosa	FEMALE
rosabal	FEMALE
rosah	FEMALE
rosalee	FEMALE
rosaleen	FEMALE
rosalia	FEMALE
rosalie	FEMALE
rosalien	FEMALE
rosaliene	FEMALE
rosalina	FEMALE
rosalind	FEMALE
rosalinda	FEMALE
rosalinde	FEMALE
rosaline	FEMALE
rosaly	FEMALE
rosalyn	FEMALE
rosalyne	FEMALE
rosamunde	FEMALE
rosan	FEMALE
rosanda	FEMALE
rosanna	FEMALE
rosanne	FEMALE
rosanno	FEMALE
rosanno	MALE
rosario	FEMALE
rosco	MALE
rose	FEMALE
rosel	FEMALE
roseliek	FEMALE
roselinde	FEMALE
roseline	FEMALE
roselique	FEMALE
roselita	FEMALE
rosella	FEMALE
rosellina	FEMALE
roselot	FEMALE
rosemarie	FEMALE
rosemyn	FEMALE
roseri	FEMALE
rosetta	FEMALE
rosette	FEMALE
roshan	MALE
rosie	FEMALE
rosielle	FEMALE
rosina	FEMALE
rosine	FEMALE
rosita	FEMALE
rosiëlle	FEMALE
rosmunda	FEMALE
ross	MALE
rossella	FEMALE
rossie	MALE
rosula	FEMALE
rosveig	FEMALE
roswita	FEMALE
roswitha	FEMALE
rosy	FEMALE
roterica	FEMALE
rouell	MALE
roufaida	FEMALE
rouis	MALE
roul	MALE
roulla	FEMALE
roumee	FEMALE
roun	FEMALE
rouven	MALE
rover	MALE
rowald	MALE
rowan	FEMALE
rowan	MALE
rowana	FEMALE
rowanne	FEMALE
rowdy	MALE
rowe	FEMALE
rowen	FEMALE
rowena	FEMALE
rowi	FEMALE
rowie	FEMALE
rowin	MALE
rowy	FEMALE
rowèna	FEMALE
roxana	FEMALE
roxane	FEMALE
roxanne	FEMALE
roxette	FEMALE
roxie	FEMALE
roxy	FEMALE
roy	MALE
royelle	FEMALE
royke	MALE
roza	FEMALE
rozanne	FEMALE
rozee	FEMALE
rozeke	FEMALE
rozemarie	FEMALE
rozemarijn	FEMALE
rozemaryn	FEMALE
rozenn	FEMALE
rozieke	FEMALE
rozonda	FEMALE
roël	MALE
roëlja	FEMALE
ruano	FEMALE
ruart	MALE
ruary	MALE
ruatger	MALE
ruben	MALE
rubens	MALE
rubian	MALE
rubim	FEMALE
rubin	MALE
rubina	FEMALE
rubine	FEMALE
ruby	FEMALE
rudella	FEMALE
rudelle	FEMALE
rudi	MALE
rudmer	MALE
rudo	MALE
rudolf	MALE
rudolfine	FEMALE
rudolfo	MALE
rudy	FEMALE
rudyard	MALE
ruel	MALE
rufo	MALE
rufus	MALE
rugea	FEMALE
ruggero	MALE
ruiz	MALE
rulinda	FEMALE
runa	FEMALE
rune	MALE
ruperto	MALE
rurik	MALE
russ	MALE
russel	MALE
russell	MALE
rustin	MALE
rusty	FEMALE
rut	FEMALE
rutger	MALE
rutgera	FEMALE
ruth	FEMALE
ruthie	FEMALE
ruthlyn	FEMALE
ruthmila	FEMALE
ruud	MALE
ruurd	MALE
ruveyda	FEMALE
ruward	MALE
ruy	MALE
ruzana	FEMALE
ruzenka	FEMALE
ry	MALE
ryan	MALE
ryanne	FEMALE
ryeau	FEMALE
ryek	MALE
rykje	FEMALE
ryleigh	FEMALE
rynk	MALE
ryoni	FEMALE
ryu	MALE
ryvano	MALE
ryèl	FEMALE
ràchel	FEMALE
rèmon	MALE
rémon	MALE
résha	FEMALE
róben	FEMALE
róisa	FEMALE
saakje	FEMALE
saar	FEMALE
saartje	FEMALE
sabah	FEMALE
sabastiaan	MALE
sabe	MALE
sabeau	FEMALE
sabella	FEMALE
sabeth	FEMALE
sabette	FEMALE
sabha	FEMALE
sabien	FEMALE
sabin	MALE
sabina	FEMALE
sabine	FEMALE
sabit	MALE
sabrina	FEMALE
sabrine	FEMALE
sabriye	FEMALE
saby	FEMALE
sacha	FEMALE
sachrael	MALE
saco	MALE
sade	FEMALE
sadhbh	FEMALE
sadia	FEMALE
sadiah	FEMALE
sadie	FEMALE
sady	FEMALE
saerlaith	FEMALE
safaa	FEMALE
safanja	FEMALE
saffira	FEMALE
saffron	FEMALE
saffrone	MALE
safia	FEMALE
safiatou	FEMALE
safiera	FEMALE
safiqua	FEMALE
safiya	FEMALE
safiyye	FEMALE
safjee	FEMALE
safri	MALE
saga	FEMALE
sagan	FEMALE
sagga	FEMALE
sagita	FEMALE
sahnisa	FEMALE
sahra	FEMALE
sahrona	FEMALE
said	MALE
saida	FEMALE
saide	FEMALE
saidja	FEMALE
saifo	FEMALE
saim	MALE
saima	FEMALE
saimelia	FEMALE
saimen	FEMALE
saimen	MALE
saimi	FEMALE
saimy	FEMALE
saira	FEMALE
saisa	FEMALE
saisha	FEMALE
saisha	MALE
sake	MALE
sakiena	FEMALE
sakieyt	FEMALE
sakina	FEMALE
salane	FEMALE
saldy	FEMALE
salem	MALE
salene	FEMALE
salih	MALE
saliha	FEMALE
salina	FEMALE
sally	FEMALE
salman	MALE
salome	FEMALE
salomee	FEMALE
salomon	MALE
saloua	FEMALE
salva	FEMALE
salvador	MALE
salvatore	MALE
salve	MALE
salvia	FEMALE
salvina	FEMALE
salvino	MALE
salvinus	MALE
salwa	FEMALE
sam	FEMALE
sam	MALE
samanmali	FEMALE
samanta	FEMALE
samantha	FEMALE
samara	FEMALE
sambath	MALE
samber	MALE
samdrina	FEMALE
samenthy	FEMALE
samhaoir	FEMALE
sami	FEMALE
samilla	FEMALE
samir	MALE
samira	FEMALE
samirah	FEMALE
samita	FEMALE
samke	FEMALE
samm	MALE
samma	FEMALE
samme	MALE
sammelie	FEMALE
sammie	FEMALE
sammis	MALE
sammy	FEMALE
samo	MALE
samson	MALE
samten	MALE
samuel	FEMALE
samuel	MALE
samyo	MALE
sancha	FEMALE
sancho	MALE
sancia	FEMALE
sanctus	MALE
sander	MALE
sanderijn	FEMALE
sanderina	FEMALE
sanderine	FEMALE
sandia	FEMALE
sandii	FEMALE
sandor	MALE
sandra	FEMALE
sandria	FEMALE
sandrijn	FEMALE
sandrina	FEMALE
sandrine	FEMALE
sandrino	MALE
sandro	MALE
sandy	FEMALE
sandy	MALE
sanella	FEMALE
sania	FEMALE
sanien	FEMALE
sanilya	FEMALE
sanita	FEMALE
sanja	FEMALE
sanna	FEMALE
sannae	FEMALE
sannah	FEMALE
sanne	FEMALE
sanne	MALE
sanneke	FEMALE
sannerien	FEMALE
sannie	FEMALE
sanny	FEMALE
sanora	FEMALE
sanson	MALE
santana	FEMALE
santasja	FEMALE
sante	MALE
santhos	MALE
santi	FEMALE
santino	MALE
santo	MALE
santonio	MALE
sanya	FEMALE
saorla	FEMALE
sape	MALE
saphira	FEMALE
saqil	MALE
sara	FEMALE
sarafina	FEMALE
sarafino	MALE
sarah	FEMALE
sarai	FEMALE
saraid	FEMALE
saranda	FEMALE
saranke	FEMALE
saranne	FEMALE
saraï	FEMALE
sarenda	FEMALE
saressa	FEMALE
saressa	FEMALE
sarge	MALE
sarhea	FEMALE
sari	FEMALE
saria	FEMALE
sarieke	FEMALE
sarima	FEMALE
sarina	FEMALE
sarine	FEMALE
sarissa	FEMALE
sarita	FEMALE
saritha	FEMALE
sarito	MALE
sarleen	FEMALE
sarolta	FEMALE
saroya	FEMALE
sasaria	FEMALE
sascha	FEMALE
sascha	MALE
saschia	FEMALE
sasja	FEMALE
saskia	FEMALE
saskya	FEMALE
sassa	FEMALE
satine	FEMALE
satish	MALE
saul	MALE
sausanna	FEMALE
savanna	FEMALE
savannah	FEMALE
saverio	MALE
savina	FEMALE
savine	FEMALE
savita	FEMALE
saviëlle	FEMALE
savo	MALE
sawan	MALE
sawena	FEMALE
sawinah	FEMALE
saxana	FEMALE
saxona	FEMALE
saya	MALE
sayen	FEMALE
sayenna	FEMALE
sayna	FEMALE
sayone	FEMALE
sayra	FEMALE
saïda	FEMALE
sbas	MALE
scander	MALE
scariett	FEMALE
scariette	FEMALE
scarlet	FEMALE
scarlett	FEMALE
scathach	FEMALE
scerai	MALE
schahrus	MALE
schauni	FEMALE
scheito	MALE
scherdion	MALE
scipio	MALE
scota	FEMALE
scott	MALE
scrollan	FEMALE
seadach	FEMALE
sean	MALE
seana	FEMALE
seanait	FEMALE
seanna	FEMALE
seb	MALE
seba	FEMALE
sebas	MALE
sebastiaan	MALE
sebastian	MALE
sebastiën	FEMALE
sebbe	MALE
seberta	FEMALE
sebo	MALE
seda	FEMALE
seerske	FEMALE
sef	MALE
sefanja	MALE
seffie	FEMALE
segeline	FEMALE
seger	MALE
segert	MALE
segio	MALE
segnat	FEMALE
seija	FEMALE
seille	FEMALE
seino	MALE
seintje	FEMALE
seiorse	MALE
seiwyn	MALE
selcan	FEMALE
selda	FEMALE
selena	FEMALE
selene	FEMALE
selfish	FEMALE
selien	FEMALE
selina	FEMALE
selinde	FEMALE
seline	FEMALE
selisha	FEMALE
selisjah	FEMALE
selke	FEMALE
selm	MALE
selma	FEMALE
selmo	MALE
selune	FEMALE
selvedin	MALE
selvie	FEMALE
selwin	MALE
selwyn	MALE
selynn	FEMALE
sem	MALE
sema	FEMALE
semanur	FEMALE
semiala	MALE
semina	FEMALE
semira	FEMALE
semm	MALE
semme	FEMALE
semme	MALE
semmy	MALE
semual	MALE
sencemilia	FEMALE
senem	FEMALE
senga	FEMALE
senn	MALE
senna	FEMALE
sennaa	FEMALE
sennah	FEMALE
senne	FEMALE
senno	MALE
senofonte	MALE
senon	MALE
sensi	FEMALE
sent	MALE
senta	FEMALE
sep	MALE
sepp	MALE
seppe	MALE
sequoyah	FEMALE
serafana	FEMALE
serafien	FEMALE
serafin	FEMALE
serafina	FEMALE
serafino	MALE
serafinus	MALE
serah	FEMALE
seraja	FEMALE
seraja	MALE
serane	FEMALE
seraphin	FEMALE
seraphina	FEMALE
seraphine	FEMALE
seray	FEMALE
serena	FEMALE
serene	FEMALE
serfine	FEMALE
serge	MALE
sergej	MALE
sergin	FEMALE
sergina	FEMALE
sergino	MALE
sergio	MALE
sergius	MALE
serha	FEMALE
serhilda	FEMALE
serhilde	FEMALE
serijn	FEMALE
serilda	FEMALE
serilde	FEMALE
serina	FEMALE
serioja	MALE
serita	FEMALE
serjoscha	MALE
serkan	MALE
serona	FEMALE
serra	FEMALE
servaas	MALE
servan	MALE
servasio	MALE
servatius	MALE
servazio	MALE
servio	MALE
servé	MALE
serène	FEMALE
seth	MALE
seva	FEMALE
sevanah	FEMALE
seven	FEMALE
seven	MALE
sevennah	FEMALE
severiano	MALE
severijn	MALE
severin	MALE
severine	FEMALE
severino	MALE
severinus	MALE
sevilay	FEMALE
sevim	FEMALE
seyfrid	MALE
seyhan	MALE
seymour	MALE
shabaaz	FEMALE
shadao	FEMALE
shadira	FEMALE
shady	MALE
shadée	FEMALE
shae	FEMALE
shaheen	MALE
shahira	FEMALE
shahla	FEMALE
shaila	FEMALE
shajen	FEMALE
shakira	FEMALE
shakka	FEMALE
shalance	FEMALE
shalina	FEMALE
shaliyah	FEMALE
shalom	MALE
shalun	MALE
shamara	FEMALE
shambhavi	FEMALE
shameree	FEMALE
shams	MALE
shamé	FEMALE
shana	FEMALE
shanaya	FEMALE
shandeeh	FEMALE
shandro	MALE
shane	MALE
shani	FEMALE
shania	FEMALE
shanice	FEMALE
shaniqua	FEMALE
shanissa	FEMALE
shanita	FEMALE
shanna	FEMALE
shannah	FEMALE
shannay	FEMALE
shannen	FEMALE
shannon	FEMALE
shanny	FEMALE
shanon	FEMALE
shanon	MALE
shantala	FEMALE
shante	FEMALE
shantie	FEMALE
shanté	FEMALE
shanygne	FEMALE
shanyka	FEMALE
shanyra	FEMALE
shaquana	FEMALE
shaquille	MALE
shaquina	FEMALE
sharai	FEMALE
sharana	FEMALE
sharda	FEMALE
shardeney	FEMALE
shardy	FEMALE
shardée	FEMALE
shareef	MALE
sharema	FEMALE
sharen	FEMALE
sharena	FEMALE
sharene	FEMALE
sharessi	FEMALE
shari	FEMALE
sharif	MALE
sharifa	FEMALE
sharim	FEMALE
sharina	FEMALE
sharinda	FEMALE
sharine	FEMALE
sharissa	FEMALE
sharita	FEMALE
shariza	FEMALE
sharla	FEMALE
sharleen	FEMALE
sharlene	FEMALE
sharli	FEMALE
sharlona	FEMALE
sharmaine	FEMALE
sharmila	FEMALE
sharmilah	FEMALE
sharon	FEMALE
sharona	FEMALE
sharonie	FEMALE
sharony	FEMALE
shasa	FEMALE
shaun	MALE
shauna	FEMALE
shauni	FEMALE
shaunni	FEMALE
shauny	FEMALE
shawanna	FEMALE
shawn	MALE
shay	MALE
shayendra	FEMALE
shaymaa	FEMALE
shaymée	FEMALE
shayna	FEMALE
shazia	FEMALE
sha’re	FEMALE
sheba	FEMALE
shedée	FEMALE
sheila	FEMALE
sheilla	FEMALE
sheilo	FEMALE
shelia	FEMALE
shelima	FEMALE
sheline	FEMALE
sheliza	FEMALE
shella	FEMALE
shelley	FEMALE
shelly	FEMALE
shelsey	FEMALE
shenaisa	FEMALE
shenda	FEMALE
shenna	FEMALE
shera	FEMALE
sheralyn	FEMALE
sheralynn	FEMALE
sherani	FEMALE
sheranie	FEMALE
sheri	FEMALE
sherida	FEMALE
sheridan	MALE
sherifa	FEMALE
sherilijn	FEMALE
sherilyn	FEMALE
sherish	FEMALE
sherita	FEMALE
sherla	FEMALE
sherlin	FEMALE
shermaine	FEMALE
sherman	MALE
sherodjeni	FEMALE
sherran	FEMALE
shervin	MALE
sheryn	FEMALE
sheyenna	FEMALE
shifra	FEMALE
shila	FEMALE
shiley	FEMALE
shimelle	FEMALE
shimona	FEMALE
shiniva	FEMALE
shinsjie	MALE
shira	FEMALE
shireen	FEMALE
shirin	MALE
shirinne	FEMALE
shirley	FEMALE
shirlina	FEMALE
shirly	FEMALE
shirlynn	FEMALE
shobhini	FEMALE
shola	FEMALE
shona	FEMALE
shonda	FEMALE
shosha	FEMALE
shoshanna	FEMALE
shota	MALE
shoura	FEMALE
shrawan	MALE
shulamit	MALE
shurandie	MALE
shurenska	FEMALE
shyam	MALE
shyena	FEMALE
shyvonne	FEMALE
siabh	FEMALE
siadhal	FEMALE
siamy	FEMALE
sianna	FEMALE
sianne	FEMALE
siard	MALE
sibald	MALE
sibbele	MALE
sibel	FEMALE
sibert	MALE
sibil	FEMALE
sibilla	FEMALE
sibille	FEMALE
sibolt	MALE
sibren	MALE
sibrene	MALE
sibrich	FEMALE
sibyl	FEMALE
sibylla	FEMALE
sibylle	FEMALE
sicco	MALE
sico	MALE
sid	MALE
sida	FEMALE
siddhartha	FEMALE
siddiq	MALE
sidney	FEMALE
sidney	MALE
sido	MALE
sidon	MALE
sidonia	FEMALE
siebe	MALE
sieben	MALE
siebert	MALE
siebke	FEMALE
siebo	MALE
siebolt	MALE
siebrand	MALE
siebren	MALE
siege	FEMALE
sieger	MALE
siegert	MALE
siegfried	MALE
sieglinde	FEMALE
siegmona	FEMALE
sieke	FEMALE
siel	FEMALE
siem	MALE
siemen	MALE
siemy	FEMALE
sien	FEMALE
sientje	FEMALE
siepe	FEMALE
sierd	MALE
sierra	FEMALE
siert	MALE
sieska	FEMALE
siet	FEMALE
siet	MALE
sieta	FEMALE
sieto	MALE
sietse	MALE
sietske	FEMALE
sietske	MALE
sietze	MALE
sieuwerd	MALE
sieuwke	FEMALE
sifke	FEMALE
sifra	FEMALE
sigal	FEMALE
siger	MALE
sigfreda	FEMALE
sigfrieda	FEMALE
sigfriede	FEMALE
sigismonda	FEMALE
signa	FEMALE
sigourny	FEMALE
sigrid	FEMALE
sigrun	FEMALE
sigstein	MALE
sigsten	MALE
sigurd	MALE
sigvard	MALE
sihem	FEMALE
siivio	MALE
sija	FEMALE
sijana	FEMALE
sijbold	MALE
sijbrand	MALE
sijbren	MALE
sijds	MALE
sije	MALE
sijmen	MALE
sika	FEMALE
sikander	MALE
sikke	MALE
sikko	MALE
sil	MALE
sila	FEMALE
silas	MALE
sile	FEMALE
silhoutte	FEMALE
silja	FEMALE
silka	FEMALE
silke	FEMALE
silke	FEMALE
sill	FEMALE
silla	FEMALE
sille	FEMALE
silva	FEMALE
silvain	MALE
silvan	MALE
silvana	FEMALE
silvania	FEMALE
silvano	MALE
silvanus	MALE
silveer	MALE
silven	MALE
silverio	MALE
silvester	MALE
silvestro	MALE
silvetta	FEMALE
silvia	FEMALE
silvian	MALE
silvie	FEMALE
silvijn	MALE
silvina	FEMALE
silvio	MALE
sima	FEMALE
simcha	MALE
simen	MALE
simeon	MALE
simke	MALE
simon	MALE
simona	FEMALE
simone	FEMALE
simone	MALE
simonetta	FEMALE
simonette	FEMALE
sina	FEMALE
sinclair	MALE
sindy	FEMALE
sine	FEMALE
sinead	FEMALE
sinep	FEMALE
sinn	MALE
sinneva	FEMALE
sinno	MALE
sinoon	MALE
sinta	FEMALE
sinthia	FEMALE
siobhan	FEMALE
siomha	FEMALE
sion	MALE
sipke	MALE
sipko	MALE
sippie	FEMALE
sipriaen	MALE
sira	FEMALE
sirana	FEMALE
siri	FEMALE
sirpa	FEMALE
sis	FEMALE
siska	FEMALE
siske	MALE
sisqo	MALE
sissel	FEMALE
sissi	FEMALE
sissie	FEMALE
sissy	FEMALE
sisto	MALE
sisyfos	MALE
sita	FEMALE
sithri	MALE
siur	MALE
siuultje	FEMALE
sivar	MALE
sivert	MALE
sivette	FEMALE
sixten	MALE
sixtus	MALE
siënna	FEMALE
sjaak	MALE
sjaco	MALE
sjahcandra	FEMALE
sjakie	MALE
sjakko	MALE
sjam	MALE
sjamana	FEMALE
sjan	FEMALE
sjan	MALE
sjanette	FEMALE
sjanieke	FEMALE
sjanien	FEMALE
sjanke	FEMALE
sjanneke	FEMALE
sjanoek	FEMALE
sjarlie	FEMALE
sjarlot	FEMALE
sjastra	FEMALE
sjastra	MALE
sjef	MALE
sjei	MALE
sjel	FEMALE
sjeng	MALE
sjimmie	MALE
sjinki	MALE
sjoerd	MALE
sjomali	MALE
sjora	FEMALE
sjors	MALE
sjorsje	FEMALE
sjorsje	MALE
sjouke	FEMALE
sjoukje	FEMALE
sjuul	MALE
sjuulke	FEMALE
skahib	MALE
skip	MALE
skipper	MALE
sky	FEMALE
skye	FEMALE
skye	MALE
skyeler	FEMALE
slaine	FEMALE
slavenko	MALE
slavica	FEMALE
sletje	FEMALE
slien	FEMALE
slim	MALE
sloane	FEMALE
slomiet	FEMALE
smantha	FEMALE
smeralda	FEMALE
smilla	FEMALE
snowy	FEMALE
soefian	MALE
soenita	FEMALE
soera	FEMALE
soeradj	MALE
soete	FEMALE
soeteken	FEMALE
soetkin	FEMALE
sofia	FEMALE
sofian	MALE
sofie	FEMALE
sofieke	FEMALE
sofietje	FEMALE
soko	MALE
sola	FEMALE
solaene	FEMALE
solaine	FEMALE
solana	FEMALE
solane	FEMALE
solange	FEMALE
solco	MALE
soleil	FEMALE
soleille	FEMALE
solita	FEMALE
solko	MALE
sollen	FEMALE
solo	MALE
soloo	FEMALE
soloo	MALE
solve	MALE
solveg	FEMALE
solveig	FEMALE
solveigh	FEMALE
solveij	FEMALE
solvej	FEMALE
solvi	MALE
solvig	FEMALE
someya	FEMALE
sona	FEMALE
sonara	FEMALE
sonet	FEMALE
sonia	FEMALE
sonja	FEMALE
sonny	MALE
sono	MALE
sonseray	FEMALE
sonsiree	FEMALE
sophia	FEMALE
sophie	FEMALE
sophietje	FEMALE
sophron	MALE
sora	FEMALE
soraida	FEMALE
soraya	FEMALE
sorcha	FEMALE
sorella	FEMALE
soren	MALE
sorena	FEMALE
soriana	FEMALE
sorina	FEMALE
sorlyn	FEMALE
soryana	FEMALE
soscha	FEMALE
soschanne	FEMALE
sosse	FEMALE
souad	FEMALE
soufiane	MALE
souhaila	FEMALE
sousha	FEMALE
soy lin	FEMALE
spela	FEMALE
spencer	MALE
speranza	FEMALE
spijker	FEMALE
spike	MALE
spiros	MALE
spyros	MALE
squall	MALE
staats	MALE
stacey	FEMALE
stach	MALE
stacy	MALE
staes	MALE
staffan	MALE
stag	MALE
stalin	MALE
stan	MALE
stance	FEMALE
stancio	MALE
stanis	MALE
stanislao	MALE
stanley	MALE
stanske	FEMALE
star	FEMALE
stas	MALE
stasi	FEMALE
stasia	FEMALE
stassha	FEMALE
stee	FEMALE
steef	MALE
stef	MALE
stefaan	MALE
stefan	MALE
stefana	FEMALE
stefania	FEMALE
stefanie	FEMALE
stefano	MALE
stefanus	MALE
steff	MALE
steffan	MALE
steffanie	FEMALE
steffanny	FEMALE
steffano	MALE
steffen	MALE
steffi	FEMALE
steffie	FEMALE
steffina	FEMALE
steffy	FEMALE
stefina	FEMALE
steie	MALE
stein	FEMALE
stein	MALE
steina	FEMALE
steinar	MALE
steinmar	MALE
stelia	FEMALE
stella	FEMALE
stellan	MALE
stellina	FEMALE
sten	MALE
stenar	MALE
stener	MALE
stenfinn	MALE
stephan	MALE
stephani	FEMALE
stephanie	FEMALE
stephanja	FEMALE
stephano	MALE
stephen	MALE
stephennie	FEMALE
stephenny	FEMALE
stepháno	MALE
stern	FEMALE
sterre	FEMALE
sterresn	FEMALE
steve	MALE
steven	MALE
steverina	FEMALE
stevie	FEMALE
stevie	MALE
stevo	MALE
steye	MALE
steyn	MALE
steyntje	FEMALE
stian	MALE
stien	FEMALE
stieneke	FEMALE
stientje	FEMALE
stijn	MALE
stijnie	FEMALE
stijntje	FEMALE
stina	FEMALE
stine	FEMALE
stofel	MALE
stoffel	MALE
stoffeltje	FEMALE
stoffer	MALE
stoneny	MALE
stoney	MALE
stony	MALE
storm	MALE
storr	MALE
strofios	MALE
stu	MALE
stuart	MALE
styn	MALE
stépanka	FEMALE
stéphane	MALE
stéphanie	FEMALE
suanach	FEMALE
suanley	MALE
suanne	FEMALE
sue	FEMALE
sue-allen	FEMALE
sue-ann	FEMALE
sueandra	FEMALE
suela	FEMALE
suen	FEMALE
suheda	MALE
sukeika	FEMALE
suleika	FEMALE
suleima	FEMALE
summer	FEMALE
sun-ok	FEMALE
sunanda	FEMALE
sunaya	FEMALE
sune	MALE
sunniva	FEMALE
sunny	FEMALE
sunny	MALE
suppatra	FEMALE
suraja	FEMALE
suraya	FEMALE
surekha	FEMALE
surinde	FEMALE
sus	MALE
susa	FEMALE
susan	FEMALE
susanna	FEMALE
susannah	FEMALE
susanne	FEMALE
susca	FEMALE
suse	FEMALE
susen	FEMALE
susi	FEMALE
susica	FEMALE
susina	FEMALE
susy	FEMALE
sutinah	FEMALE
suus	FEMALE
suuz	FEMALE
suzan	FEMALE
suzana	FEMALE
suzanna	FEMALE
suzanne	FEMALE
suze	FEMALE
suzejla	FEMALE
suzeline	FEMALE
suzella	FEMALE
suzet	FEMALE
suzette	FEMALE
suzie	FEMALE
svante	MALE
svea	FEMALE
svein	MALE
sven	MALE
svend	MALE
svenja	FEMALE
svenka	FEMALE
svenne	FEMALE
svenny	MALE
sverre	MALE
svetlana	FEMALE
svetlanah	FEMALE
swaantje	FEMALE
swaen	MALE
swanica	FEMALE
swaniek	FEMALE
swanique	FEMALE
swannet	FEMALE
sweder	MALE
sweer	MALE
swen	MALE
swenia	FEMALE
swenja	FEMALE
swier	MALE
swinda	FEMALE
swinta	FEMALE
swoosie	FEMALE
sya	FEMALE
syarina	FEMALE
syb	MALE
sybe	MALE
sybich	FEMALE
sybilla	FEMALE
sybille	FEMALE
sybolt	MALE
sybout	MALE
sybrand	MALE
sybren	MALE
sybrenne	FEMALE
sybrina	FEMALE
sydney	FEMALE
syenna	FEMALE
sygourneigh	FEMALE
sygrid	FEMALE
syiva	FEMALE
sylba	FEMALE
sylke	FEMALE
sylphide	FEMALE
sylt	MALE
sylva	FEMALE
sylvain	MALE
sylvan	MALE
sylvana	FEMALE
sylvano	MALE
sylvene	FEMALE
sylvester	MALE
sylvi	FEMALE
sylvia	FEMALE
sylviane	FEMALE
sylvie	FEMALE
symen	MALE
sypko	MALE
syrah	FEMALE
syriah	FEMALE
syrinx	FEMALE
sytse	MALE
sytske	FEMALE
sy’rai	FEMALE
sy’rai	FEMALE
sy’ria	FEMALE
szu	FEMALE
sölva	FEMALE
sölve	MALE
sören	MALE
süle	FEMALE
tabatha	FEMALE
tabe	MALE
tabeia	FEMALE
tabitha	FEMALE
tabo	MALE
taco	MALE
tad	MALE
tadeo	MALE
tadeus	MALE
tadeusz	MALE
taedse	MALE
taeije	MALE
taeike	MALE
taeke	MALE
taekle	MALE
taetse	MALE
taetske	FEMALE
tafary	FEMALE
tahar	MALE
tahia	FEMALE
tahir	MALE
tahira	FEMALE
tahnee	FEMALE
taila	FEMALE
taillte	FEMALE
taina	FEMALE
taisha	FEMALE
tait	MALE
taj	MALE
take	MALE
takele	MALE
takje	FEMALE
takje	MALE
tale	MALE
talegien	FEMALE
talgje	FEMALE
talia	FEMALE
talida	FEMALE
talika	FEMALE
talina	FEMALE
talis	MALE
talisha	FEMALE
talita	FEMALE
talitha	FEMALE
taliya	FEMALE
talje	FEMALE
tallie	FEMALE
tally	MALE
talula	FEMALE
tama	FEMALE
tamar	FEMALE
tamara	FEMALE
tamarinde	FEMALE
tamas	MALE
tame	MALE
tamer	MALE
tamesha	FEMALE
tamia	FEMALE
tamila	FEMALE
tamino	MALE
tamira	FEMALE
tammes	MALE
tammie	FEMALE
tammo	MALE
tammy	FEMALE
tamra	FEMALE
tamson	MALE
tamsyn	FEMALE
tanacha	FEMALE
tancredi	MALE
tandy	FEMALE
tanel	MALE
tanguy	MALE
tanhé	FEMALE
tania	FEMALE
tanisha	FEMALE
tanita	FEMALE
tanitia	FEMALE
tanja	FEMALE
tanjura	FEMALE
tankja	FEMALE
tanne	FEMALE
tannee	FEMALE
tanneke	FEMALE
tannie	FEMALE
tanny	FEMALE
tantalos	MALE
tantra	FEMALE
tanya	FEMALE
tané	FEMALE
taomara	FEMALE
tara	FEMALE
taran	MALE
tarea	FEMALE
tari	FEMALE
tarick	MALE
tarik	MALE
tarkan	MALE
tars	MALE
tasharell	FEMALE
tashi	FEMALE
tashina	FEMALE
tasio	MALE
tasja	FEMALE
tassos	MALE
tata	FEMALE
tate	MALE
tatiana	FEMALE
tatja	FEMALE
tatjana	FEMALE
tatum	FEMALE
tatyana	FEMALE
taus	MALE
tay	MALE
tayari	MALE
tayina	FEMALE
taylan	MALE
tayler	MALE
taylor	FEMALE
taziana	FEMALE
tazio	MALE
taïna	FEMALE
teade	MALE
teafa	FEMALE
teake	MALE
teakele	MALE
teakle	MALE
teamhair	FEMALE
teatse	MALE
tebaldo	MALE
tecla	FEMALE
ted	FEMALE
ted	MALE
tedd	MALE
tedde	MALE
teddie	FEMALE
teddy	FEMALE
tede	MALE
teele	MALE
teeta	FEMALE
teetse	MALE
tefka	FEMALE
teide	FEMALE
teide	MALE
teije	MALE
teijm	MALE
teis	MALE
teite	MALE
teja	FEMALE
teke	MALE
tekele	MALE
tekke	MALE
tekkie	FEMALE
tekmessa	FEMALE
teko	MALE
telamoon	MALE
telle	MALE
telte	MALE
temair	FEMALE
temro	MALE
tense	FEMALE
tenzing	MALE
teobaldo	MALE
teodor	MALE
teodora	FEMALE
teodoro	MALE
teoman	MALE
tera	FEMALE
terco	MALE
terea	FEMALE
terencio	MALE
teresa	FEMALE
terese	FEMALE
tereza	FEMALE
teri	FEMALE
terje	MALE
terka	FEMALE
teroska	FEMALE
terpsichore	FEMALE
terra	FEMALE
terre	FEMALE
terry	MALE
terry-lynn	FEMALE
teruska	FEMALE
tes	MALE
teska	FEMALE
teske	FEMALE
tess	FEMALE
tessa	FEMALE
tessaly	FEMALE
tesse	MALE
tessel	FEMALE
tesseliene	FEMALE
tessie	FEMALE
tessy	FEMALE
tet	MALE
tete	MALE
tethys	FEMALE
tetse	MALE
tetske	FEMALE
tette	MALE
teun	MALE
teunette	FEMALE
teuni	FEMALE
teunice	FEMALE
teuntje	FEMALE
teus	MALE
tevin	MALE
thabita	FEMALE
thade	MALE
thaisa	FEMALE
thaiti	FEMALE
thaleia	FEMALE
thalia	FEMALE
thalien	FEMALE
thalina	FEMALE
thalisa	FEMALE
thalisha	FEMALE
thalissa	FEMALE
thalitha	FEMALE
thamar	FEMALE
thamara	FEMALE
thanatos	MALE
thanisia	FEMALE
thari	FEMALE
thasia	FEMALE
thaïsa	FEMALE
thea	FEMALE
thei	MALE
theia	FEMALE
thekla	FEMALE
thelja	FEMALE
thelma	FEMALE
thelmo	MALE
themis	FEMALE
thenya	FEMALE
theo	MALE
theodor	MALE
theodora	FEMALE
theodorus	MALE
theophano	MALE
thera	FEMALE
theres	FEMALE
theresa	FEMALE
therese	FEMALE
theresia	FEMALE
theresina	FEMALE
therezka	FEMALE
therk	MALE
thery	FEMALE
theseus	MALE
thessa	FEMALE
thetis	FEMALE
theunielle	FEMALE
theunis	MALE
thiad	MALE
thiamo	MALE
thibauld	MALE
thibault	MALE
thibaut	MALE
thibeau	MALE
thibo	MALE
thidrek	MALE
thieme	MALE
thiemen	MALE
thierry	MALE
thiery	MALE
thies	MALE
thiffanie	FEMALE
thijm	MALE
thijme	MALE
thijmen	MALE
thijmo	MALE
thijn	MALE
thijs	MALE
thilde	FEMALE
thilina	FEMALE
thilman	MALE
thimo	MALE
thinka	FEMALE
thirsa	FEMALE
thirza	FEMALE
thirze	FEMALE
thjálfi	MALE
thoas	MALE
thom	MALE
thoma	MALE
thomas	MALE
thome	MALE
thommy	MALE
thor	MALE
thora	FEMALE
thoraya	FEMALE
thorben	MALE
thordis	FEMALE
thordur	MALE
thore	MALE
thorin	MALE
thorn	MALE
thorne	MALE
thorold	MALE
thorstein	MALE
thorsten	MALE
thorvald	MALE
thorwald	MALE
thorwen	MALE
thuur	MALE
thye	MALE
thyestes	MALE
thym	MALE
thymen	MALE
thymo	MALE
thymon	MALE
thyne	FEMALE
thyne	MALE
thyra	FEMALE
thyrell	MALE
thyri	FEMALE
thyro	MALE
thyrone	MALE
thyrsa	FEMALE
thyrvi	FEMALE
thyrza	FEMALE
thysa	FEMALE
thècle	FEMALE
tia	FEMALE
tiago	MALE
tiako	MALE
tiami	FEMALE
tiamo	MALE
tiana	FEMALE
tianca	FEMALE
tianda	FEMALE
tianne	FEMALE
tiare	FEMALE
tiarna	FEMALE
tiba	FEMALE
tibbe	MALE
tibelda	FEMALE
tiberio	MALE
tiberius	MALE
tibje	FEMALE
tibo	MALE
tibor	MALE
tichen	FEMALE
ticho	MALE
tichon	MALE
tico	MALE
tidde	MALE
tiddo	MALE
tide	MALE
tideman	MALE
tido	MALE
tie	FEMALE
tiede	MALE
tiederieks	MALE
tieje	MALE
tieke	MALE
tiele	MALE
tieleman	MALE
tiem	MALE
tieme	MALE
tiemen	MALE
tiemke	FEMALE
tiemolle	MALE
tieneke	FEMALE
ties	MALE
tiese	MALE
tiesto	MALE
tiete	MALE
tietse	MALE
tiffanie	FEMALE
tiffany	FEMALE
tiger	MALE
tigo	MALE
tijana	FEMALE
tijani	MALE
tijde	MALE
tijdo	MALE
tijgo	MALE
tijl	MALE
tijmen	MALE
tijn	MALE
tijo	MALE
tijs	MALE
tike	MALE
tiki	FEMALE
tikke	MALE
tikva	FEMALE
tikvah	FEMALE
tikyana	FEMALE
til	FEMALE
tila	FEMALE
tilak	MALE
tilde	FEMALE
tile	MALE
till	MALE
tilly	FEMALE
tilman	MALE
tilou	FEMALE
tim	MALE
timber	MALE
timbert	MALE
timco	MALE
time	MALE
timen	MALE
timi	MALE
timie	MALE
timientje	FEMALE
timmy	MALE
timna	FEMALE
timo	MALE
timolos	MALE
timon	MALE
timoteo	MALE
timotheus	MALE
timothy	MALE
timoty	MALE
timpe	MALE
timur	MALE
tina	FEMALE
tinca	FEMALE
tine	FEMALE
tineke	FEMALE
tinetta	FEMALE
tini	MALE
tink	FEMALE
tinka	FEMALE
tinke	FEMALE
tinne	FEMALE
tino	FEMALE
tino	MALE
tinsley	FEMALE
tinus	MALE
tiny	FEMALE
tiny	MALE
tio	MALE
tionne	FEMALE
tip	MALE
tippy	FEMALE
tirian	MALE
tirina	FEMALE
tirsa	FEMALE
tirza	FEMALE
tisha	FEMALE
tist	MALE
tite	MALE
titia	FEMALE
titiaan	MALE
titiana	FEMALE
tito	MALE
titte	MALE
titus	MALE
tizia	FEMALE
tiziana	FEMALE
tiziano	MALE
tizzia	FEMALE
tjaard	MALE
tjaarda	FEMALE
tjaark	MALE
tjabbe	MALE
tjabe	MALE
tjabine	FEMALE
tjacco	MALE
tjade	MALE
tjakke	MALE
tjakko	MALE
tjako	MALE
tjal	MALE
tjalf	MALE
tjalina	FEMALE
tjalle	MALE
tjalling	MALE
tjalve	MALE
tjamke	FEMALE
tjamko	MALE
tjango	MALE
tjarco	MALE
tjarda	FEMALE
tjardo	MALE
tjark	MALE
tjarko	MALE
tjas	MALE
tjasse	MALE
tjaze	MALE
tjeark	MALE
tjebbe	MALE
tjebbo	MALE
tjeerd	MALE
tjeert	MALE
tjelvar	MALE
tjen	MALE
tjendo	MALE
tjerk	MALE
tjerkje	FEMALE
tjerry	MALE
tjesse	MALE
tjetse	MALE
tjeu	MALE
tjeuvo	MALE
tjibbe	MALE
tjimkje	FEMALE
tjipke	MALE
tjische	MALE
tjiske	MALE
tjisse	MALE
tjits	MALE
tjitse	MALE
tjitske	FEMALE
tjitte	MALE
tjobo	MALE
tjokke	MALE
tjomme	MALE
tjores	MALE
tjorven	FEMALE
toar	MALE
tobe	MALE
tobey	MALE
tobia	FEMALE
tobias	MALE
tobie	MALE
tobin	MALE
toby	MALE
todd	MALE
todor	MALE
toechka	FEMALE
toetie	MALE
toin	MALE
toine	MALE
toka	MALE
tolga	MALE
tom	MALE
toma	MALE
tomas	MALE
tomaso	MALE
tomasz	MALE
tomelina	FEMALE
tommaso	MALE
tomme	FEMALE
tomme	MALE
tommie	MALE
tommy	MALE
tomomi	FEMALE
tomás	MALE
ton	MALE
tonda	FEMALE
tone	FEMALE
toni	FEMALE
toni	MALE
tonia	FEMALE
tonie	MALE
tonika	FEMALE
tonino	MALE
tonio	MALE
tonis	MALE
tonja	FEMALE
tonke	MALE
tonko	MALE
tonneke	FEMALE
tonnie	MALE
tonnis	MALE
tonny	FEMALE
tonny	MALE
tonu	MALE
tony	MALE
tonya	FEMALE
toon	MALE
toos	FEMALE
tooske	FEMALE
top	MALE
topenca	FEMALE
tora	FEMALE
torben	MALE
torbern	MALE
torbjörn	MALE
torbjørn	MALE
tordis	FEMALE
tore	MALE
torgeir	MALE
torgen	MALE
tori	FEMALE
toria	FEMALE
torild	FEMALE
torquato	MALE
torstein	MALE
torsten	MALE
torvald	MALE
tos	MALE
tosca	FEMALE
toscha	FEMALE
tosha	FEMALE
toska	FEMALE
tossing	MALE
toste	MALE
toto	MALE
totte	MALE
touriya	FEMALE
tousan	MALE
toussaint	MALE
tova	FEMALE
tove	FEMALE
towje	MALE
toya	FEMALE
toyah	FEMALE
tracy	FEMALE
tracy	MALE
trea	FEMALE
treasa	FEMALE
treat	MALE
trees	FEMALE
treintje	FEMALE
treise	FEMALE
tren	MALE
trent	MALE
trentino	MALE
treny	MALE
tresita	FEMALE
tresja	FEMALE
trevor	MALE
trey	MALE
treze	FEMALE
trianca	FEMALE
trianet	FEMALE
tribeca	FEMALE
tricia	FEMALE
trick	MALE
triencke	FEMALE
trienke	FEMALE
trijn	FEMALE
trijnco	MALE
trijnie	FEMALE
trijntje	FEMALE
trine	FEMALE
trinette	FEMALE
trini	FEMALE
trinidad	FEMALE
trinity	FEMALE
trisha	FEMALE
trishelle	FEMALE
triska	FEMALE
tristan	MALE
tristano	MALE
tristel	FEMALE
tristen	MALE
triston	MALE
trix	FEMALE
trixi	FEMALE
trixie	FEMALE
troy	MALE
tru	FEMALE
trudchen	FEMALE
trude	FEMALE
trudeke	FEMALE
trudel	FEMALE
trudelien	FEMALE
trudi	FEMALE
trudie	FEMALE
trudo	MALE
trudy	FEMALE
trudys	FEMALE
trui	FEMALE
truus	FEMALE
truy	FEMALE
try	MALE
tryfon	MALE
trygve	MALE
trynie	FEMALE
trynko	MALE
tryntje	FEMALE
trysran	MALE
trystan	MALE
trystram	MALE
trühe	MALE
tsahai	FEMALE
tsilia	FEMALE
tsjade	MALE
tsjamke	MALE
tsjark	MALE
tsjasse	MALE
tsjassing	MALE
tsjeed	MALE
tsjeedse	MALE
tsjemke	MALE
tsjerk	MALE
tsjerke	MALE
tsjetse	MALE
tsjette	MALE
tsjibbe	MALE
tsjibbet	MALE
tsjidse	MALE
tsjidsger	MALE
tsjiesse	MALE
tsjiete	MALE
tsjiets	MALE
tsjietse	MALE
tsjietsje	MALE
tsjimke	MALE
tsjirk	MALE
tsjise	MALE
tsjisse	MALE
tsjits	MALE
tsjitser	MALE
tsjitske	FEMALE
tsjitte	MALE
tsjomme	MALE
tsjumme	MALE
tuathla	FEMALE
tuchen	MALE
tuco	MALE
tuesday	FEMALE
tuffy	FEMALE
tuija	FEMALE
tula	FEMALE
tulmore	FEMALE
tumac	MALE
tunde	FEMALE
tunnes	MALE
tunnies	MALE
tuomas	MALE
tusfaje	MALE
twan	MALE
twannie	MALE
twanny	FEMALE
twiggy	FEMALE
twister	MALE
tyara	FEMALE
tyarra	FEMALE
tyas	MALE
tycho	MALE
tydo	MALE
tygo	MALE
tyiescha	FEMALE
tyl	MALE
tyler	MALE
tymen	MALE
tymo	MALE
tymon	MALE
tyn	MALE
tyna	FEMALE
tyndareos	MALE
tyne	FEMALE
typ	MALE
tyra	FEMALE
tyree	MALE
tyrell	MALE
tyrese	MALE
tyroma	FEMALE
tyrone	MALE
tyrza	FEMALE
tyson	MALE
tyvianka	FEMALE
tzeitel	FEMALE
téa	FEMALE
tülây	FEMALE
uaine	FEMALE
uallach	FEMALE
ubbe	MALE
ubbo	MALE
ubele	MALE
uberto	MALE
ubu	MALE
ucha	FEMALE
uche	FEMALE
uda	FEMALE
udele	FEMALE
udella	FEMALE
udelle	FEMALE
udeshika	FEMALE
udo	MALE
uey	MALE
uffert	MALE
ugo	MALE
ugolino	MALE
ugone	MALE
uiltje	FEMALE
ula	FEMALE
ulanda	FEMALE
ulbe	MALE
ulbien	FEMALE
ulbina	FEMALE
ulbo	MALE
ulco	MALE
ulderico	MALE
ulfried	MALE
ulinda	FEMALE
ulita	FEMALE
ulitta	FEMALE
uljana	FEMALE
ulker	FEMALE
ulku	FEMALE
ulla	FEMALE
ulli	FEMALE
ullmara	FEMALE
ulmara	FEMALE
ulrica	FEMALE
ulrich	MALE
ulrick	MALE
ulrik	MALE
ulrika	FEMALE
ulrike	FEMALE
ulrique	MALE
ultsje	FEMALE
ulva	FEMALE
ulyssa	FEMALE
ulysses	MALE
uma	FEMALE
umberta	FEMALE
umberto	MALE
umbretta	FEMALE
umit	MALE
umma	FEMALE
una	FEMALE
una	FEMALE
unah	FEMALE
undine	FEMALE
unia	FEMALE
unico	MALE
urania	FEMALE
urbain	MALE
urban	MALE
urbano	MALE
urbanus	MALE
uri	MALE
uria	FEMALE
uriana	FEMALE
urias	MALE
uriel	MALE
urith	FEMALE
uriëlle	FEMALE
urley	MALE
ursel	FEMALE
ursela	FEMALE
ursi	FEMALE
ursina	FEMALE
ursine	FEMALE
ursio	MALE
ursula	FEMALE
uschi	FEMALE
usha	FEMALE
ushaya	FEMALE
ushi	FEMALE
usianne	FEMALE
usola	FEMALE
ustasia	FEMALE
uta	FEMALE
ute	FEMALE
utie	FEMALE
uus	FEMALE
vadim	MALE
vaila	FEMALE
val	MALE
vala	FEMALE
valantino	MALE
valborg	FEMALE
valborga	FEMALE
valburga	FEMALE
valda	FEMALE
valdemar	MALE
valdhar	MALE
valeer	MALE
valencia	FEMALE
valente	MALE
valentia	FEMALE
valentijn	MALE
valentin	MALE
valentina	FEMALE
valentine	FEMALE
valentino	MALE
valentinus	MALE
valentyn	MALE
valere	MALE
valeria	FEMALE
valeriana	FEMALE
valeriane	FEMALE
valeriano	MALE
valerie	FEMALE
valerien	FEMALE
valerine	FEMALE
valerio	MALE
valerius	MALE
valery	FEMALE
valesca	FEMALE
valeska	FEMALE
valiant	MALE
valida	FEMALE
valke	MALE
vallery	FEMALE
vally	FEMALE
valmar	MALE
valura	FEMALE
valérie	FEMALE
van	MALE
vanadis	FEMALE
vandita	FEMALE
vanessa	FEMALE
vania	FEMALE
vanina	FEMALE
vanity	FEMALE
vanja	FEMALE
vanne	MALE
vanni	FEMALE
vannity	FEMALE
vanya	FEMALE
varinia	FEMALE
varinka	FEMALE
varsha	FEMALE
vasant	MALE
vasco	MALE
vasil	MALE
vasili	MALE
vasiljka	FEMALE
vassil	MALE
vassili	MALE
vasterd	MALE
vastert	MALE
vaughn	MALE
vaughnda	FEMALE
vaya	FEMALE
ved	MALE
veda	FEMALE
veenerick	MALE
veerle	FEMALE
vees	MALE
veit	MALE
vejay	MALE
vela	FEMALE
velda	FEMALE
velicia	FEMALE
velika	FEMALE
velma	FEMALE
velo	MALE
velten	MALE
venance	FEMALE
venantius	MALE
venceslas	MALE
venceslás	MALE
venesuela	FEMALE
veneta	FEMALE
venethia	FEMALE
venetia	FEMALE
venetta	FEMALE
venga	FEMALE
vengar	MALE
venice	FEMALE
venicia	FEMALE
venne	FEMALE
vens	MALE
venus	FEMALE
venya	FEMALE
vera	FEMALE
veran	FEMALE
verano	MALE
verelien	FEMALE
verena	FEMALE
vergilius	MALE
veria	FEMALE
verica	FEMALE
verine	FEMALE
verity	FEMALE
vern	MALE
verna	FEMALE
verner	MALE
vernie	FEMALE
vernon	MALE
veroline	FEMALE
veron	MALE
verona	FEMALE
verone	FEMALE
verones	MALE
veronica	FEMALE
veronie	FEMALE
veronieck	FEMALE
veroniek	FEMALE
veronika	FEMALE
veronique	FEMALE
verusca	FEMALE
veruschka	FEMALE
vesko	MALE
vesna	FEMALE
vesta	FEMALE
vestal	MALE
vester	MALE
vesterd	MALE
veva	FEMALE
veysel	MALE
vianca	FEMALE
vianette	FEMALE
vianey	MALE
vianne	FEMALE
vianny	MALE
vibeke	FEMALE
vic	MALE
vicco	MALE
vicente	MALE
vicky	FEMALE
vico	MALE
victoire	FEMALE
victor	MALE
victoria	FEMALE
victoriano	MALE
victorien	FEMALE
victorina	FEMALE
victorine	FEMALE
victorio	MALE
vidal	MALE
vidar	MALE
videlle	FEMALE
vidija	FEMALE
viefke	FEMALE
vien	MALE
viene	FEMALE
vienna	FEMALE
vieve	FEMALE
vigdis	FEMALE
viggio	MALE
viggo	MALE
vigo	MALE
vijai	MALE
vik	MALE
vika	FEMALE
vikas	MALE
vike	MALE
viki	FEMALE
viktor	MALE
viktoria	FEMALE
viktorin	FEMALE
viktorina	FEMALE
viktorine	FEMALE
viletta	FEMALE
ville	MALE
villian	FEMALE
vilma	FEMALE
vilmar	MALE
vilmos	MALE
vin	MALE
vina	FEMALE
vinanda	FEMALE
vinay	MALE
vince	MALE
vincent	MALE
vincente	MALE
vincenth	MALE
vincentin	MALE
vincenz	MALE
vincenzo	MALE
vineta	FEMALE
ving	MALE
vinja	FEMALE
vinny	MALE
vinten	MALE
vinus	MALE
viola	FEMALE
violanda	FEMALE
violanda	MALE
violanta	FEMALE
violet	FEMALE
violeta	FEMALE
violett	FEMALE
violetta	FEMALE
violette	FEMALE
vir	FEMALE
vira	FEMALE
virge	FEMALE
virgil	MALE
virgini	FEMALE
virginia	FEMALE
virginie	FEMALE
virna	FEMALE
virte	FEMALE
vita	FEMALE
vital	MALE
vitale	MALE
vitalis	MALE
vitas	MALE
vito	MALE
vitorio	MALE
vittero	MALE
vitto	MALE
vittore	MALE
vittoria	FEMALE
vittorino	MALE
vittorio	MALE
viv	FEMALE
viva	FEMALE
vivanne	FEMALE
vivi	FEMALE
vivian	FEMALE
vivian	MALE
viviane	FEMALE
vivianne	FEMALE
viviano	MALE
vivica	FEMALE
vivien	FEMALE
vivienne	FEMALE
vivy	FEMALE
vladimir	MALE
vladimira	FEMALE
vlasta	FEMALE
volcan	MALE
volfango	MALE
volkan	MALE
volker	MALE
volkert	MALE
volmer	MALE
vondie	FEMALE
vonetta	FEMALE
vonneke	FEMALE
vos	MALE
vosmar	MALE
vreneli	FEMALE
vreni	FEMALE
vroni	FEMALE
vronie	FEMALE
vroon	FEMALE
vroukje	FEMALE
vuiko	MALE
vyacheslav	MALE
vyasa	MALE
vyella	FEMALE
vyvian	FEMALE
václav	MALE
vénice	FEMALE
véronique	FEMALE
vérène	FEMALE
waast	MALE
wabe	MALE
waddish	FEMALE
wade	MALE
wahiba	FEMALE
walborga	FEMALE
walburg	FEMALE
walburga	FEMALE
walburge	FEMALE
walda	FEMALE
waldburg	FEMALE
waldemar	MALE
walderina	FEMALE
waldie	MALE
waldo	MALE
walentina	FEMALE
walid	MALE
walinda	FEMALE
wallace	MALE
walli	FEMALE
wally	FEMALE
wally	MALE
walpurgis	FEMALE
walter	MALE
waltraut	FEMALE
wampie	FEMALE
wanda	FEMALE
wandie	FEMALE
wandis	FEMALE
wandre	MALE
wanita	FEMALE
wanne	MALE
wannes	MALE
wapke	FEMALE
ward	MALE
warda	FEMALE
wardi	MALE
warenka	FEMALE
waris	MALE
warja	FEMALE
warre	MALE
warren	MALE
warris	MALE
warry	MALE
warse	MALE
warsha	FEMALE
wart	MALE
washington	MALE
watzelina	FEMALE
wayan	MALE
wayley	MALE
waylon	MALE
webke	FEMALE
wednesday	FEMALE
weifie	FEMALE
weintje	FEMALE
weiske	FEMALE
welda	FEMALE
welmoed	FEMALE
welmoet	FEMALE
wencke	FEMALE
wenda	FEMALE
wendel	FEMALE
wendel	MALE
wendel	MALE
wendela	FEMALE
wendelien	FEMALE
wendelina	FEMALE
wendeline	FEMALE
wendie	FEMALE
wendy	FEMALE
wenke	FEMALE
wenne	MALE
wenneke	FEMALE
wennelien	FEMALE
wenske	FEMALE
werna	FEMALE
werner	MALE
werner	MALE
wes	MALE
wes	MALE
wesley	MALE
wesley	MALE
wessel	MALE
wessel	MALE
wesseline	FEMALE
wester	MALE
weya	FEMALE
wezel	MALE
whipple	FEMALE
whit	MALE
whoopie	FEMALE
wia	FEMALE
wianka	FEMALE
wianne	FEMALE
wiard	MALE
wiba	FEMALE
wibeke	FEMALE
wibens	MALE
wibi	MALE
wibke	FEMALE
wibo	MALE
wibren	MALE
wichard	MALE
wick	MALE
wico	MALE
wido	MALE
wiebe	MALE
wiebelien	FEMALE
wiebke	FEMALE
wiebrand	MALE
wiebren	MALE
wiebrig	MALE
wiebrigje	FEMALE
wiecher	MALE
wiedeke	FEMALE
wieger	MALE
wieke	FEMALE
wiekert	MALE
wieky	FEMALE
wieland	MALE
wien	MALE
wiena	FEMALE
wienanda	FEMALE
wieneke	FEMALE
wienk	MALE
wienold	MALE
wiep	FEMALE
wiep	MALE
wiepke	FEMALE
wieringen	FEMALE
wies	FEMALE
wies	MALE
wiesje	FEMALE
wieske	FEMALE
wiet	MALE
wieteke	FEMALE
wieteke	MALE
wietse	MALE
wietske	FEMALE
wietze	MALE
wieze	MALE
wigberta	FEMALE
wigbold	MALE
wigdis	FEMALE
wigger	MALE
wiggert	MALE
wiirik	MALE
wija	FEMALE
wijbrand	MALE
wijgert	MALE
wijke	FEMALE
wijnand	MALE
wijnanda	FEMALE
wijnie	MALE
wik	MALE
wikje	FEMALE
wikje	MALE
wikke	MALE
wil	FEMALE
wil	MALE
wilanka	FEMALE
wilber	MALE
wilbert	MALE
wilbrand	MALE
wilco	MALE
wildrik	MALE
wileen	FEMALE
wilf	FEMALE
wilfred	MALE
wilfreda	FEMALE
wilfredo	MALE
wilfreida	FEMALE
wilfried	MALE
wilfrieda	FEMALE
wilfriede	FEMALE
wilgo	MALE
wilheim	MALE
wilhelm	MALE
wilhelma	FEMALE
wilhelmien	FEMALE
wilhelmina	FEMALE
wilhelmine	FEMALE
wilhelmus	MALE
wiliona	FEMALE
wilja	FEMALE
wiljan	MALE
wiljanne	FEMALE
wiljo	MALE
wiljon	MALE
wilke	FEMALE
wilkin	MALE
wilko	MALE
willa	FEMALE
willard	MALE
willeen	FEMALE
willeke	FEMALE
willem	MALE
willemein	FEMALE
willemeintje	FEMALE
willemiek	FEMALE
willemieke	FEMALE
willemien	FEMALE
willemientje	FEMALE
willemijn	FEMALE
willemijntje	FEMALE
willemine	FEMALE
willemtien	FEMALE
willemyn	FEMALE
willepien	FEMALE
william	MALE
willianne	FEMALE
willibald	MALE
willibrord	MALE
willie	MALE
williene	FEMALE
willienke	FEMALE
willisa	FEMALE
williëtte	FEMALE
willo	MALE
willona	FEMALE
willow	FEMALE
wills	MALE
willy	FEMALE
willy	MALE
wilm	MALE
wilma	FEMALE
wilmar	MALE
wilmer	MALE
wilmiena	FEMALE
wilmy	FEMALE
wilrieke	FEMALE
wilrien	FEMALE
wilske	FEMALE
wilson	MALE
wilte	MALE
wim	MALE
wimco	MALE
wimjan	MALE
win	MALE
wina	FEMALE
winand	MALE
winanda	FEMALE
winant	MALE
windsor	MALE
wine	MALE
wineke	FEMALE
winette	FEMALE
winfred	MALE
winfried	MALE
winifred	FEMALE
winifrieda	FEMALE
winita	FEMALE
winke	FEMALE
winkler	MALE
winne	MALE
winni	FEMALE
winnie	FEMALE
winnie	MALE
winnifred	FEMALE
winnitou	MALE
winny	FEMALE
wino	MALE
winola	FEMALE
winona	FEMALE
winsor	MALE
winston	MALE
winter	MALE
wiona	FEMALE
wiro	MALE
wironi	FEMALE
wisja	MALE
wiske	FEMALE
wisse	MALE
witta	FEMALE
witte	MALE
witze	MALE
wivina	FEMALE
wladimir	MALE
wlanda	FEMALE
wobbe	MALE
woi	MALE
wolbert	MALE
wolf	MALE
wolfgang	MALE
wolfraad	FEMALE
wolfram	MALE
wolmet	FEMALE
wolmet	FEMALE
wolter	MALE
woody	MALE
wopke	MALE
wosa	MALE
wouke	FEMALE
wout	MALE
wouter	MALE
woutje	FEMALE
woutrien	FEMALE
wouwke	FEMALE
wubbo	MALE
wubo	MALE
wyanda	FEMALE
wybe	MALE
wybran	MALE
wybrand	MALE
wybren	MALE
wyke	FEMALE
wyko	MALE
wylanda	FEMALE
wynand	MALE
wyndeline	FEMALE
wyneke	FEMALE
wynn	MALE
wynne	FEMALE
wyno	MALE
wynona	FEMALE
wynton	MALE
wypkje	FEMALE
wysaby	FEMALE
wytse	MALE
wytska	FEMALE
wytske	FEMALE
wytze	MALE
xadi	FEMALE
xam	MALE
xamara	FEMALE
xana	FEMALE
xander	MALE
xandor	MALE
xandor	MALE
xandra	FEMALE
xandrien	FEMALE
xandrijn	MALE
xandrine	FEMALE
xanne	FEMALE
xante	FEMALE
xanthe	FEMALE
xanthi	MALE
xanthine	FEMALE
xanthippe	FEMALE
xantho	MALE
xanthé	FEMALE
xanti	MALE
xarah	FEMALE
xarles	MALE
xaro	MALE
xatenea	FEMALE
xaveer	MALE
xaver	MALE
xaveria	FEMALE
xaveriano	MALE
xaverine	FEMALE
xaverio	MALE
xaverius	MALE
xavi	MALE
xavie	FEMALE
xavier	MALE
xaviera	FEMALE
xavina	FEMALE
xeley	FEMALE
xena	FEMALE
xenia	FEMALE
xenita	FEMALE
xenza	FEMALE
xer	FEMALE
xeropilate	MALE
xerxes	FEMALE
xerxes	MALE
xiamara	FEMALE
xianne	FEMALE
xiao	FEMALE
xiao	MALE
xiao hui	FEMALE
xilio	MALE
xilja	FEMALE
xim	MALE
ximena	FEMALE
xin-ju	MALE
xina	FEMALE
xineya	FEMALE
xiomar	MALE
xiomara	FEMALE
xiomarah	FEMALE
xippe	MALE
xochitl	FEMALE
xoethos	MALE
xunday	MALE
xynthia	FEMALE
yaan	MALE
yade	FEMALE
yadira	FEMALE
yael	FEMALE
yaell	MALE
yaella	FEMALE
yaellah	FEMALE
yago	MALE
yahli	FEMALE
yaika	FEMALE
yair	MALE
yaira	FEMALE
yaira	MALE
yajinti	FEMALE
yakima	FEMALE
yaleesa	FEMALE
yalisa	FEMALE
yalou	FEMALE
yamal	MALE
yamilana	FEMALE
yamilla	FEMALE
yamina	FEMALE
yan	MALE
yana	FEMALE
yanah	FEMALE
yanaika	FEMALE
yaneh	FEMALE
yanek	MALE
yanick	MALE
yaniek	MALE
yanita	FEMALE
yanko	MALE
yanna	FEMALE
yannah	FEMALE
yannai	FEMALE
yanne	FEMALE
yanni	MALE
yannick	MALE
yanniek	FEMALE
yannik	MALE
yannika	FEMALE
yannina	FEMALE
yannique	FEMALE
yannis	MALE
yanno	FEMALE
yanou	FEMALE
yanouk	FEMALE
yante	FEMALE
yanthe	FEMALE
yantho	MALE
yao	MALE
yaquira	FEMALE
yara	FEMALE
yarah	FEMALE
yarara	FEMALE
yaren	FEMALE
yari	MALE
yariek	MALE
yarne	MALE
yarno	MALE
yaro	MALE
yaron	MALE
yarum	FEMALE
yasemin	FEMALE
yasha	MALE
yasim	MALE
yasimin	FEMALE
yasmae	FEMALE
yasmee	FEMALE
yasmijn	FEMALE
yasmila	FEMALE
yasmin	FEMALE
yasmina	FEMALE
yasmine	FEMALE
yassin	MALE
yassine	MALE
yassir	MALE
yato	MALE
yavanna	FEMALE
yaya	FEMALE
yazmin	FEMALE
yaël	MALE
yaëlla	FEMALE
ybe	MALE
ybele	MALE
ybeltje	FEMALE
ybne	MALE
yda	FEMALE
yde	MALE
yeal	FEMALE
yeanine	FEMALE
yel	MALE
yeldred	FEMALE
yeldred	MALE
yelena	FEMALE
yeliz	FEMALE
yelke	FEMALE
yendi	FEMALE
yenko	MALE
yenn	MALE
yente	FEMALE
yentel	FEMALE
yenthe	FEMALE
yentl	FEMALE
yentle	FEMALE
yera	FEMALE
yerai	FEMALE
yerasa	FEMALE
yeshe	FEMALE
yesin	MALE
yesper	MALE
yessica	FEMALE
yessie	FEMALE
yessina	FEMALE
yesta	FEMALE
yesyes	FEMALE
yevgeny	MALE
yevée	FEMALE
yezury	FEMALE
yf	MALE
yfke	FEMALE
yildes	FEMALE
yilmaz	MALE
yin	FEMALE
yinga	FEMALE
yinnar	FEMALE
yip	MALE
yiri	MALE
yirko	MALE
yiste	FEMALE
ykara	FEMALE
yke	FEMALE
ykje	FEMALE
ylena	FEMALE
ylenia	FEMALE
ylke	FEMALE
ylona	FEMALE
ylonka	FEMALE
ylva	FEMALE
yme	MALE
yme	MALE
ymke	FEMALE
ymkje	FEMALE
ymo	MALE
yndiah	FEMALE
ynje	FEMALE
yno	MALE
ynske	FEMALE
ynte	MALE
ynze	MALE
yoanique	FEMALE
yob	MALE
yoeki	FEMALE
yoeran	MALE
yoeri	MALE
yoerik	MALE
yoerike	FEMALE
yogita	FEMALE
yoica	FEMALE
yoka	FEMALE
yoko	FEMALE
yola	FEMALE
yolanda	FEMALE
yolande	FEMALE
yolanthe	FEMALE
yole	FEMALE
yoleigh	FEMALE
yolente	FEMALE
yolinde	FEMALE
yoline	FEMALE
yonah	FEMALE
yoni	FEMALE
yoni	MALE
yonice	FEMALE
yonne	FEMALE
yootha	FEMALE
yora	FEMALE
yoram	MALE
yoran	MALE
yorben	MALE
yordi	MALE
yordin	MALE
yoren	FEMALE
yorgo	MALE
yori	MALE
yorick	MALE
yorieke	FEMALE
yorinde	FEMALE
yorit	MALE
yoritt	MALE
york	MALE
yorna	FEMALE
yorrick	MALE
yosha	FEMALE
yoshi	MALE
yoshka	FEMALE
yoshua	FEMALE
yosri	MALE
yossi	MALE
yosta	FEMALE
youad	MALE
youandi	FEMALE
younes	MALE
youp	MALE
yourek	MALE
youri	MALE
youry	MALE
youssef	MALE
yoyitha	FEMALE
ype	MALE
ypeus	MALE
yri	MALE
yrida	FEMALE
yris	FEMALE
yrjo	MALE
yrsa	FEMALE
ysanne	FEMALE
ysbrand	MALE
ysilda	FEMALE
ysis	FEMALE
yteke	FEMALE
ytje	FEMALE
ytse	MALE
ytzen	MALE
yu-long	MALE
yuki	MALE
yul	MALE
yula	FEMALE
yuna	FEMALE
yura	MALE
yuran	MALE
yurena	FEMALE
yuri	MALE
yurina	FEMALE
yurrin	MALE
yussel	MALE
yustin	MALE
yusuf	MALE
yuta	FEMALE
yuta	MALE
yuthan	MALE
yuval	MALE
yvana	FEMALE
yvanca	FEMALE
yvanka	FEMALE
yvar	MALE
yveline	FEMALE
yven	MALE
yverne	FEMALE
yves	MALE
yvet	FEMALE
yvette	FEMALE
yvie	FEMALE
yvo	MALE
yvon	MALE
yvonne	FEMALE
yzana	FEMALE
yüksel	MALE
zabeth	FEMALE
zachairas	MALE
zacharias	MALE
zachary	FEMALE
zacherry	MALE
zachery	MALE
zada	FEMALE
zadie	FEMALE
zadok	MALE
zaffira	FEMALE
zafira	FEMALE
zahra	FEMALE
zaida	FEMALE
zainam	MALE
zakaria	MALE
zaki	MALE
zakira	FEMALE
zakiya	FEMALE
zald	MALE
zale	FEMALE
zalia	FEMALE
zamir	MALE
zamira	FEMALE
zana	FEMALE
zander	MALE
zandr	MALE
zandra	FEMALE
zane	MALE
zaneta	FEMALE
zanna	FEMALE
zanne	FEMALE
zanoah	MALE
zanthe	FEMALE
zara	FEMALE
zarah	FEMALE
zaria	FEMALE
zarita	FEMALE
zarzuèla	FEMALE
zasha	MALE
zay	MALE
zayenna	FEMALE
zaynab	FEMALE
zaza	FEMALE
zaïda	FEMALE
zaïde	FEMALE
zdena	FEMALE
zdenek	MALE
zdenka	FEMALE
zdenko	MALE
zdeòka	FEMALE
zea	FEMALE
zealanda	FEMALE
zeb	MALE
zebada	FEMALE
zebedeus	MALE
zebo	MALE
zed	MALE
zedekia	FEMALE
zee	MALE
zeeg	MALE
zeegert	MALE
zeeshaan	MALE
zef	MALE
zefalinda	FEMALE
zefanja	FEMALE
zefanja	MALE
zeferino	MALE
zeffirina	FEMALE
zegeline	FEMALE
zeger	MALE
zegert	MALE
zehra	FEMALE
zeke	MALE
zekiya	FEMALE
zelda	FEMALE
zele	FEMALE
zelia	FEMALE
zelie	FEMALE
zelina	FEMALE
zelinda	FEMALE
zelma	FEMALE
zelmira	FEMALE
zen	MALE
zena	FEMALE
zenaide	FEMALE
zenda	FEMALE
zendor	MALE
zeni	FEMALE
zenia	FEMALE
zenina	FEMALE
zenna	FEMALE
zenne	FEMALE
zennep	FEMALE
zennie	FEMALE
zeno	MALE
zenobia	FEMALE
zenobia	FEMALE
zenobie	FEMALE
zenon	MALE
zenorbi	FEMALE
zenzel	FEMALE
zenzi	FEMALE
zep	MALE
zephalinda	FEMALE
zephanie	FEMALE
zephier	FEMALE
zephirah	FEMALE
zeppe	FEMALE
zerelda	FEMALE
zerina	FEMALE
zerla	FEMALE
zerlina	FEMALE
zerlinda	FEMALE
zerline	FEMALE
zero	MALE
zeta	FEMALE
zethra	FEMALE
zetta	FEMALE
zeus	MALE
zev	MALE
zeva	FEMALE
zeynep	FEMALE
zeïda	FEMALE
zhanna	FEMALE
zia	FEMALE
zian	FEMALE
ziara	FEMALE
zias	MALE
zico	MALE
zidane	MALE
zididine	MALE
ziggy	MALE
ziko	MALE
zilla	FEMALE
zillah	FEMALE
zilli	FEMALE
zilpah	FEMALE
zilvester	MALE
zina	FEMALE
zinah	FEMALE
zinedine	MALE
zinia	FEMALE
zinnia	FEMALE
zino	MALE
zinzi	FEMALE
zion	MALE
zippora	FEMALE
zipporah	FEMALE
zirko	MALE
ziska	FEMALE
zita	FEMALE
zitta	FEMALE
ziva	FEMALE
zixten	MALE
ziya	FEMALE
zjoske	FEMALE
zjuul	MALE
zlatan	MALE
zoa	FEMALE
zoana	FEMALE
zoe	MALE
zoebier	MALE
zoelie	FEMALE
zoey	FEMALE
zofeyah	FEMALE
zohara	FEMALE
zohra	FEMALE
zoi	FEMALE
zoja	FEMALE
zola	FEMALE
zolda	FEMALE
zoltán	MALE
zomer	FEMALE
zonne	FEMALE
zono	MALE
zonor	MALE
zora	FEMALE
zorah	FEMALE
zoraima	FEMALE
zoran	MALE
zorana	FEMALE
zorica	FEMALE
zorin	MALE
zorina	FEMALE
zorine	FEMALE
zoro	MALE
zosja	FEMALE
zowie	MALE
zoya	FEMALE
zozima	FEMALE
zozimène	FEMALE
zoé	FEMALE
zoéline	FEMALE
zoë	FEMALE
zoëlle	FEMALE
zoïa	FEMALE
zsa	FEMALE
zsazsa	FEMALE
zsofi	FEMALE
zsolt	MALE
zsuzsi	FEMALE
zubeyde	FEMALE
zuleika	FEMALE
zulema	FEMALE
zulma	FEMALE
zus	FEMALE
zusenna	FEMALE
zuzana	FEMALE
zuzanna	FEMALE
zvi	MALE
zvonko	MALE
zwaan	FEMALE
zwaan	MALE
zwaantje	FEMALE
zwanetta	FEMALE
zwanette	FEMALE
zweder	MALE
zweer	MALE
zweitse	MALE
zwier	MALE
zwiertje	FEMALE
zyra	FEMALE
zyrich	FEMALE
zyridch	MALE
zäzilie	FEMALE
zéfira	FEMALE
zéla	FEMALE
zéline	FEMALE
zélotte	FEMALE
zénaïda	FEMALE
zénonina	FEMALE
zénovia	FEMALE
zéphirine	FEMALE
zéphyrine	FEMALE
zéra	FEMALE
zérane	FEMALE
zölestina	FEMALE
çagla	FEMALE
çayla	FEMALE
