AOK-	FEMALE
APO-	MALE
Abfall	MALE
Abfallbeseitigung	MALE
Abfallentsorgung	MALE
Abfallprodukt	MALE
Abfallsammlung	MALE
Abfallvermeidung	MALE
Abfallwirtschaft	MALE
Abfallzweckverband	MALE
Abfassen	MALE
Abfassung	MALE
Abfertigungshalle	MALE
Abfertigungskapazität	MALE
Abfindung	MALE
Abfindungsangebot	MALE
Abfindungszahlung	MALE
Abflachung	MALE
Abflug	MALE
Abflugmöglichkeit	MALE
Abflugsort	MALE
Abflugszeit	MALE
Abflugtag	MALE
Abflugtermin	MALE
Abflugterminal	MALE
Abflugzeit	MALE
Abfluss	MALE
Abfuhrunternehmen	MALE
Abführung	MALE
Abfüllbetrieb	MALE
Abfüller	MALE
Abgabe	MALE
Abgabenentlastung	MALE
Abgabenlast	MALE
Abgabenordnung	MALE
Abgabeschluss	MALE
Abgang	MALE
Abgasanschluss	MALE
Abgasnorm	MALE
Abgeordnet	MALE
Abgeordnetenhaus	MALE
Abgeordnetenkammer	MALE
Abgeordnetenmandat	MALE
Abgeordnetenmord	MALE
Abgeordnetenrecht	MALE
Abgeordnetensitz	MALE
Abgesandt	MALE
Abgesaugtwerden	MALE
Abgeschiedenheit	MALE
Abgrenzung	MALE
Abgrund	MALE
Abgründigkeit	MALE
Abhilfe	MALE
Abholservice	MALE
Abholung	MALE
Abholzung	MALE
Abholzungsrate	MALE
Abhängig	MALE
Abhängigkeit	MALE
Abhören	MALE
Abhörmöglichkeit	MALE
Abi	MALE
Abi-	MALE
Abitur	MALE
Abiturient	MALE
Abiturprüfung	MALE
Abitursprüfung	MALE
Abkanzler	MALE
Abkehr	MALE
Abkommen	MALE
Abkommensgegner	MALE
Abkoppelung	MALE
Abkömmling	MALE
Abkühlung	MALE
Abkürzung	MALE
Abkürzungsverzeichnis	MALE
Ablage	MALE
Ablauf	MALE
Ablaufoptimierung	MALE
Ableger	MALE
Ablegestelle	MALE
Ablegung	MALE
Ablehnung	MALE
Ablehnungsmehrheit	MALE
Ableistung	MALE
Ablenkung	MALE
Ablenkungsmanöver	MALE
Ablesewinkel	MALE
Ablösegebühr	MALE
Ablösung	MALE
Abmachung	MALE
Abmahnung	MALE
Abmarkierung	MALE
Abmessung	MALE
Abnabelung	MALE
Abnahme	MALE
Abnehmer	MALE
Abnehmerseite	MALE
Abneigung	MALE
Abnormitäten	MALE
Abnutzung	MALE
Abonnement	MALE
Abonnementssiegerin	MALE
Abonnent	MALE
Abordnung	MALE
Aborigine	MALE
Abpfiff	MALE
Abrechnung	MALE
Abrechnungssache	MALE
Abrechnungszeitraum	MALE
Abreise	MALE
Abreisetag	MALE
Abreisetermin	MALE
Abriegelung	MALE
Abriss	MALE
Abrißlücke	MALE
Abrufung	MALE
Abrüstung	MALE
Abrüstungsausschuß	MALE
Abrüstungsvertrag	MALE
Absacker	MALE
Absage	MALE
Absagen	MALE
Absandung	MALE
Absatz	MALE
Absatzaussicht	MALE
Absatzeinbusse	MALE
Absatzeinbuße	MALE
Absatzkurve	MALE
Absatzmarkt	MALE
Absatzrückgang	MALE
Absatzsituation	MALE
Abschaffung	MALE
Abschaltung	MALE
Abschaltzeit	MALE
Abschiebehaft	MALE
Abschiebehindernis	MALE
Abschiebehäftling	MALE
Abschiebestopp	MALE
Abschiebung	MALE
Abschied	MALE
Abschiedsbrief	MALE
Abschiedsempfang	MALE
Abschiedsfest	MALE
Abschiedskonzert	MALE
Abschiedsrede	MALE
Abschiedswerk	MALE
Abschlag	MALE
Abschlagszahlung	MALE
Abschlagszeit	MALE
Abschlagzeit	MALE
Abschlepp-	MALE
Abschlepperei	MALE
Abschlepphaken	MALE
Abschleppkosten	MALE
Abschleppmanöver	MALE
Abschleppwagen	MALE
Abschluss	MALE
Abschlussarbeit	MALE
Abschlussbericht	MALE
Abschlussfest	MALE
Abschlussfeuerwerk	MALE
Abschlussprüfung	MALE
Abschlusssitzung	MALE
Abschlussspiel	MALE
Abschlussveranstaltung	MALE
Abschlußbericht	MALE
Abschlußerklärung	MALE
Abschn.	MALE
Abschnitt	MALE
Abschottung	MALE
Abschottungsfunktion	MALE
Abschreckung	MALE
Abschreibebedingung	MALE
Abschreibung	MALE
Abschreibungsbedarf	MALE
Abschreibungsbedingungen	MALE
Abschreibungsmöglichkeit	MALE
Abschwung	MALE
Abschwächung	MALE
Abschätzung	MALE
Abseilstelle	MALE
Absender	MALE
Absicherung	MALE
Absicht	MALE
Absichtsbekundung	MALE
Absichtserklärung	MALE
Absingen	MALE
Absolutheit	MALE
Absolutismus	MALE
Absolvent	MALE
Absolventin	MALE
Absolvierung	MALE
Absonderung	MALE
Abspaltung	MALE
Abspann	MALE
Absperrung	MALE
Abspielgerät	MALE
Absprache	FEMALE
Abstammung	FEMALE
Abstand	FEMALE
Abstecher	FEMALE
Absteige	FEMALE
Abstellanlage	FEMALE
Abstellraum	FEMALE
Abstieg	FEMALE
Abstiegskampf	FEMALE
Abstimmung	FEMALE
Abstimmungsergebnis	FEMALE
Abstimmungsniederlage	FEMALE
Abstimmungsverhalten	FEMALE
Abstinenz	FEMALE
Abstoßung	FEMALE
Abstrafung	FEMALE
Abstraktion	FEMALE
Abstrich	FEMALE
Abstufung	FEMALE
Absturz	FEMALE
Absturzstelle	FEMALE
Absurdität	FEMALE
Abtei	FEMALE
Abteil	FEMALE
Abteil	FEMALE
Abteilung	FEMALE
Abteilungsleiter	FEMALE
Abteilungsleitung	FEMALE
Abtreibung	FEMALE
Abtreibungsrecht	FEMALE
Abtreibungsregelung	FEMALE
Abtretung	FEMALE
Ahnung	FEMALE
Ahnung	FEMALE
Albanien	MALE
Albert-	MALE
Alkohol	MALE
Alkoholeinwirkung	MALE
Alkoholiker	MALE
Alkoholismus	MALE
Alkoholkonsum	MALE
Alkoholkontrollen	MALE
Alkoholkranke	MALE
Alltagskultur	FEMALE
Alltagsleben	FEMALE
Alltagstauglichkeit	FEMALE
Altersteilzeit	FEMALE
Altersversorgung	FEMALE
Altersvorsorge	FEMALE
Altersweitsichtigkeit	FEMALE
Altersübergangsgeld	FEMALE
Altertum	FEMALE
Altertümerverwaltung	FEMALE
Alterung	FEMALE
Alterungsprozeß	FEMALE
Altfallregelung	FEMALE
Altflüchtling	FEMALE
Altgerät	FEMALE
Altglascontainer	FEMALE
Altherrenvorsteher	FEMALE
Altistin	FEMALE
Altkleider	FEMALE
Altkredit	FEMALE
Altlast	FEMALE
Altlasten	FEMALE
Altmedikamente	FEMALE
Altmeister	FEMALE
Aminosäure	FEMALE
Analogie	FEMALE
Analphabetenrate	FEMALE
Analphabetismus	FEMALE
Analyse	FEMALE
Analysierer	FEMALE
Analysis	FEMALE
Analyst	FEMALE
Analytik	FEMALE
Analytiker	FEMALE
Anamnese	FEMALE
Ananas	FEMALE
Anarchie	FEMALE
Anarchismus	FEMALE
Anarchist	FEMALE
Anfang	MALE
Anfangseinkommen	MALE
Anfangsgehalt	MALE
Anfangsphase	MALE
Anfangstermin	MALE
Anfangszeit	FEMALE
Anfechtung	FEMALE
Anfechtungsklage	FEMALE
Anfeindung	FEMALE
Anfertigung	FEMALE
Anfeuerung	FEMALE
Anforderung	FEMALE
Anforderungsprofil	FEMALE
Anfrage	FEMALE
Anfälligkeit	FEMALE
Anfängerzahl	FEMALE
Anführer	FEMALE
Anführungszeichen	FEMALE
Angabe	FEMALE
Angabetermin	FEMALE
Angeberei	FEMALE
Angebot	FEMALE
Angebotsbedingung	FEMALE
Angebotsform	FEMALE
Angebotskraft	FEMALE
Angebotspolitik	FEMALE
Angebotsportfolio	FEMALE
Angebotsqualität	FEMALE
Angebotsseite	FEMALE
Angehörig	FEMALE
Angehöriger	FEMALE
Angeklagt	FEMALE
Angel	FEMALE
Angelegenheit	FEMALE
Angeln	FEMALE
Angelpunkt	FEMALE
Angemessenheit	FEMALE
Angst	FEMALE
Angstgegner	FEMALE
Angstschrei	FEMALE
Angststörung	FEMALE
Anklang	MALE
Ankleideraum	MALE
Ankleidezimmer	MALE
Anknüpfung	MALE
Anknüpfungspunkt	MALE
Ankoppelung	MALE
Ankunft	MALE
Ankunftsabend	MALE
Ankunftstag	MALE
Ankunftszeit	MALE
Ankurbelung	MALE
Ankündigung	MALE
Anlage	MALE
Anlageangebot	MALE
Anlagebetrüger	MALE
Anlagefirma	MALE
Anlagegeschäft	MALE
Anlageinvestition	MALE
Anlagekapazität	MALE
Anlagemöglichkeit	MALE
Anlagenbau	MALE
Anlagenbaukonzern	MALE
Anlagentechnik	MALE
Anlagenteil	MALE
Anlagenteile	MALE
Anlageprofi	MALE
Anlageschwerpunkt	MALE
Anlagevermögen	MALE
Anlass	MALE
Anlass	MALE
Anlastung	MALE
Anlauf	MALE
Anlaufdefizit	MALE
Anlaufkosten	MALE
Anlaufpunkt	MALE
Anlaufschwierigkeit	MALE
Anlaufstelle	MALE
Anlaufverlust	MALE
Anlaufzeit	MALE
Anleger	MALE
Anlegung	MALE
Anlehnung	MALE
Anleihe	MALE
Anleitung	MALE
Anliegen	MALE
Anlieger	MALE
Anliegerkreisen	MALE
Anliegerverkehr	MALE
Anmarsch	MALE
Anmaßung	MALE
Anmeldeformular	MALE
Anmeldegesuch	MALE
Anmeldeschluss	MALE
Anmeldung	MALE
Anmeldungsdatum	MALE
Anmerkung	MALE
Anmietung	MALE
Annahme	FEMALE
Annahmeerklärung	FEMALE
Annale	FEMALE
Ansicht	FEMALE
Ansiedlung	FEMALE
Ansiedlungsgebiet	FEMALE
Ansinnen	FEMALE
Anspannung	FEMALE
Anspielung	FEMALE
Ansprache	FEMALE
Ansprechpartner	FEMALE
Ansprechpartnerin	FEMALE
Anspruch	FEMALE
Anstalt	FEMALE
Anstecknadeln	FEMALE
Ansteckung	FEMALE
Anstellung	FEMALE
Anstellungsvertrag	FEMALE
Anstich	FEMALE
Anstieg	FEMALE
Anstoß	FEMALE
Anstrengung	FEMALE
Anstrich	FEMALE
Antagonist	FEMALE
Antrag	MALE
Antragsdauer	MALE
Antragsformular	MALE
Antragsfrist	MALE
Antragsgegner	MALE
Antragsgegnerin	MALE
Antragskommission	MALE
Antragsschluß	MALE
Antragsstellerin	MALE
Antragsstellung	MALE
Antragsteller	MALE
Antragsunterlage	MALE
Antragsverfahren	MALE
Antrieb	MALE
Antriebskraft	MALE
Antriebsschwäche	MALE
Antritt	MALE
Antrittsbesuch	MALE
Antrittsvorlesung	MALE
Antroposophie	MALE
Anweisung	FEMALE
Anwender	FEMALE
Anwendertyp	FEMALE
Anwendung	FEMALE
Anwendungsbereich	FEMALE
Anwendungseinschränkung	FEMALE
Anwendungsfall	FEMALE
Anwendungsgebiet	FEMALE
Anwendungsmöglichkeit	FEMALE
Anwendungsprogramm	FEMALE
Anwerbeversuch	FEMALE
Anwerbung	FEMALE
Anwesen	FEMALE
Anwesend	FEMALE
Anwesenheit	FEMALE
Anwohner	FEMALE
Anzahl	FEMALE
Anzahlung	FEMALE
Anzeichen	FEMALE
Anzeige	FEMALE
Anzeigengeschäft	FEMALE
Anzeigenschaltung	FEMALE
Anzeigepflicht	FEMALE
Anziehung	FEMALE
Anziehungskraft	FEMALE
Anziehungspunkt	FEMALE
Anämie	FEMALE
Anästhesie	FEMALE
Apfelsaft	MALE
Aphorismus	MALE
Apokalypse	MALE
Arbeit	FEMALE
Arbeiten	FEMALE
Arbeiter	FEMALE
ArbeiterInnen	FEMALE
Arbeiterbewegung	FEMALE
Arbeiterin	FEMALE
Arbeiterklasse	FEMALE
Arbeiterpartei	FEMALE
Arbeiterprotest	FEMALE
Arbeitersamariterbund	FEMALE
Arbeiterschaft	FEMALE
Arbeiterunruhen	FEMALE
Arbeitervereinigung	FEMALE
Arbeiterversammlungen	FEMALE
Arbeitgeber	FEMALE
Arbeitgeberanteil	FEMALE
Arbeitgeberbeitrag	FEMALE
Arbeitgeberin	FEMALE
Arbeitgeberlager	FEMALE
Arbeitgeberseite	FEMALE
Arbeitgeberverband	FEMALE
Arbeitgeberzuschuss	FEMALE
Arbeitnehmer	FEMALE
Arbeitnehmerbeteiligung	FEMALE
Arbeitnehmerfrage	FEMALE
Arbeitnehmerfreizügigkeit	FEMALE
Arbeitnehmerfunktionär	FEMALE
Arbeitnehmerin	FEMALE
Arbeitnehmerinteresse	FEMALE
Arbeitnehmerorganisation	FEMALE
Arbeitnehmerrecht	FEMALE
Arbeitnehmerschaft	FEMALE
Arbeitnehmerseite	FEMALE
Arbeitnehmersparvertrag	FEMALE
Arbeitnehmervertreter	FEMALE
Arbeitnehmervertretung	FEMALE
Arbeitsablauf	FEMALE
Arbeitsagentur	FEMALE
Arbeitsalltag	FEMALE
Arbeitsamt	FEMALE
Arbeitsatmosphäre	FEMALE
Arbeitsaufnahme	FEMALE
Arbeitsaufwand	FEMALE
Arbeitsausschuss	FEMALE
Arbeitsbedingung	FEMALE
Arbeitsbelastung	FEMALE
Arbeitsbemessung	FEMALE
Arbeitsbereich	FEMALE
Arbeitsbeschaffungsmaßnahme	FEMALE
Arbeitsbeschaffungsprogramm	FEMALE
Arbeitsbesprechung	FEMALE
Arbeitsbesuch	FEMALE
Arbeitsbeziehung	FEMALE
Arbeitsbildung	FEMALE
Arbeitsblatt	FEMALE
Arbeitsdirektor	FEMALE
Arbeitsdruck	FEMALE
Arbeitseinheit	FEMALE
Arbeitseinkommen	FEMALE
Arbeitseinsatz	FEMALE
Arbeitsgelegenheit	FEMALE
Arbeitsgemeinschaft	FEMALE
Arbeitsgericht	FEMALE
Arbeitsgesellschaft	FEMALE
Arbeitsgesetz	FEMALE
Arbeitsgesetzgebung	FEMALE
Arbeitsgespräch	FEMALE
Arbeitsgruppe	FEMALE
Arbeitshilfe	FEMALE
Arbeitskampf	FEMALE
Arbeitskollege	FEMALE
Arbeitskonflikt	FEMALE
Arbeitskosten	FEMALE
Arbeitskraft	FEMALE
Arbeitskreis	FEMALE
Arbeitskräftewanderung	FEMALE
Arbeitslager	FEMALE
Arbeitsleben	FEMALE
Arbeitslehre	FEMALE
Arbeitsleistung	FEMALE
Arbeitsleiter	FEMALE
Arbeitslohn	FEMALE
Arbeitslos	FEMALE
Arbeitslosengeld	FEMALE
Arbeitslosenhilfe	FEMALE
Arbeitslosenquote	FEMALE
Arbeitslosenunterstützung	FEMALE
Arbeitslosenversicherung	FEMALE
Arbeitslosenzahl	FEMALE
Arbeitslosigkeit	FEMALE
Arbeitsmarkt	FEMALE
Arbeitsmarkt-	FEMALE
Arbeitsmarkteffekt	FEMALE
Arbeitsmarktförderung	FEMALE
Arbeitsmarktmaßnahme	FEMALE
Arbeitsmarktpolitik	FEMALE
Arbeitsmarktprobleme	FEMALE
Arbeitsmarktreform	FEMALE
Arbeitsmarkttheorie	FEMALE
Arbeitsmaterial	FEMALE
Arbeitsmedizinerin	FEMALE
Arbeitsmethode	FEMALE
Arbeitsminister	FEMALE
Arbeitsministerin	FEMALE
Arbeitsministerium	FEMALE
Arbeitsmittagessen	FEMALE
Arbeitsmittel	FEMALE
Arbeitsmöglichkeit	FEMALE
Arbeitsniederlegung	FEMALE
Arbeitsorganisation	FEMALE
Arbeitsort	FEMALE
Arbeitspaket	FEMALE
Arbeitspartei	FEMALE
Arbeitspensum	FEMALE
Arbeitsphase	FEMALE
Arbeitsplan	FEMALE
Arbeitsplatz	FEMALE
Arbeitsplatzabbau	FEMALE
Arbeitsplatzbeschreibungen	FEMALE
Arbeitsplatzentwicklung	FEMALE
Arbeitsplatzfolge	FEMALE
Arbeitsplatzgarantie	FEMALE
Arbeitsplatzsicherheit	FEMALE
Arbeitsplatzverlust	FEMALE
Arbeitsplatzverteilung	FEMALE
Arbeitsplatzzusage	FEMALE
Arbeitsproduktivität	FEMALE
Arbeitsprogramm	FEMALE
Arbeitsprozess	FEMALE
Arbeitsprozeß	FEMALE
Arbeitsquartier	FEMALE
Arbeitsraum	FEMALE
Arbeitsrecht	FEMALE
Arbeitsreise	FEMALE
Arbeitsschiedsgericht	FEMALE
Arbeitsschritt	FEMALE
Arbeitsschutz	FEMALE
Arbeitsschutzaspekt	FEMALE
Arbeitsschwerpunkt	FEMALE
Arbeitsseminar	FEMALE
Arbeitssicherheit	FEMALE
Arbeitssituation	FEMALE
Arbeitssitzung	FEMALE
Arbeitsspeicher	FEMALE
Arbeitsstelle	FEMALE
Arbeitsstoff	FEMALE
Arbeitsstunde	FEMALE
Arbeitsstätte	FEMALE
Arbeitssuchend	FEMALE
Arbeitstag	FEMALE
Arbeitstechnik	FEMALE
Arbeitsteilung	FEMALE
Arbeitstempo	FEMALE
Arbeitsthema	FEMALE
Arbeitstitel	FEMALE
Arbeitstreffen	FEMALE
Arbeitsuchend	FEMALE
Arbeitsumfang	FEMALE
Arbeitsumfeld	FEMALE
Arbeitsunfall	FEMALE
Arbeitsunfähigkeit	FEMALE
Arbeitsunfähigkeitsbescheinigung	FEMALE
Arbeitsverdichtung	FEMALE
Arbeitsverhältnis	FEMALE
Arbeitsvermittlung	FEMALE
Arbeitsvertrag	FEMALE
Arbeitsverwaltung	FEMALE
Arbeitsweise	FEMALE
Arbeitswelt	FEMALE
Arbeitswirtschaft	FEMALE
Arbeitswoche	FEMALE
Arbeitswohlfahrt	FEMALE
Arbeitszeit	FEMALE
Arbeitszeiterhöhung	FEMALE
Arbeitszeitmodell	FEMALE
Arbeitszeitregelung	FEMALE
Arbeitszeitverkürzung	FEMALE
Arbeitszeitverlängerung	FEMALE
Arbeitszimmer	FEMALE
Arbeitszufriedenheit	FEMALE
Architektur	FEMALE
Architekturabsolvent	FEMALE
Architekturbüro	FEMALE
Architekturinteressierte	FEMALE
Architekturpublizist	FEMALE
Architekturzeitschrift	FEMALE
Archiv	FEMALE
Archivale	FEMALE
Archivar	FEMALE
Archivgut	FEMALE
Archivierung	FEMALE
Archivkraft	FEMALE
Archivnummer	FEMALE
Archäologe	FEMALE
Archäologie	FEMALE
Ard-	FEMALE
Area	FEMALE
Areal	FEMALE
Arena	FEMALE
Asche	FEMALE
Aschenbecher	FEMALE
Aschenbild	FEMALE
Aschenbrödel	FEMALE
Askese	FEMALE
Asko-	FEMALE
Aspekt	FEMALE
Atlanta	MALE
Aufenthalt	MALE
Aufenthaltsbefugnis	MALE
Aufenthaltsbereich	MALE
Aufenthaltsbewilligung	MALE
Aufenthaltsdauer	MALE
Aufenthaltserlaubnis	MALE
Aufenthaltsgenehmigung	MALE
Aufenthaltsmöglichkeit	MALE
Aufenthaltsort	MALE
Aufenthaltsraum	MALE
Aufenthaltsrecht	MALE
Aufenthaltsstatus	MALE
Aufenthaltstitel	MALE
Aufenthaltswoche	MALE
Auferstehung	MALE
Auffahrunfall	MALE
Auffanggesellschaft	MALE
Auffassung	MALE
Auffassungsgabe	MALE
Aufforderung	MALE
Aufforstung	MALE
Auffälligkeit	MALE
Aufführung	MALE
Aufführungsorte	MALE
Aufführungstermine	MALE
Aufgabe	MALE
Aufgabenbereich	MALE
Aufgabenerfüllung	MALE
Aufgabenfeld	MALE
Aufgabengebiet	MALE
Aufgabenkritik	MALE
Aufgabenliste	MALE
Aufgabenspektrum	MALE
Aufgabenstellung	MALE
Aufgabenteilung	MALE
Aufgabenverteilung	MALE
Aufgeregtheit	MALE
Aufheben	MALE
Aufhebung	MALE
Aufhebungsvertrag	MALE
Aufholprozeß	MALE
Aufkleber	MALE
Aufklärer	MALE
Aufklärung	MALE
Aufklärungsarbeit	MALE
Aufklärungsbedarf	MALE
Aufklärungseinsatz	MALE
Aufklärungsflugzeug	MALE
Aufklärungspflicht	MALE
Aufklärungssatellit	MALE
Aufkommen	MALE
Auflage	MALE
Auflagefläche	MALE
Auflaufform	MALE
Auflehnung	MALE
Auflistung	MALE
Auflösung	MALE
Auflösung	MALE
Aufmachung	MALE
Aufmerksamkeit	MALE
Aufmunterung	MALE
Aufnahme	MALE
Aufnahmeantrag	MALE
Aufnahmefähigkeit	MALE
Aufnahmeprüfung	MALE
Aufnahmetechnologie	MALE
Aufpflasterung	MALE
Aufprallgeschwindigkeit	MALE
Aufprallsicherheit	MALE
Aufpreis	MALE
Aufrechterhaltung	MALE
Aufregung	MALE
Aufruf	MALE
Aufrüstung	MALE
Aufsatz	MALE
Aufschiebung	MALE
Aufschlag	MALE
Aufschluss	MALE
Aufschlüsselung	MALE
Aufschrei	MALE
Aufschrift	MALE
Aufschub	MALE
Aufschwung	MALE
Aufseher	MALE
Aufsicht	MALE
Aufsichtsbehörde	MALE
Aufsichtsgremium	MALE
Aufsichtspflicht	MALE
Aufsichtsrat	MALE
Aufsichtsratschef	MALE
Aufsichtsratsentscheidung	MALE
Aufsichtsratsmandat	MALE
Aufsichtsratsmitglied	MALE
Aufsichtsratspräsident	MALE
Aufsichtsratssitzung	MALE
Aufsichtsratsvorsitz	MALE
Aufsichtsratsvorsitzend	MALE
Aufsichtsregelung	MALE
Aufspaltung	MALE
Aufstand	MALE
Aufstandsfläche	MALE
Aufstandsgebiet	MALE
Aufstehen	MALE
Aufsteiger	MALE
Aufstellung	MALE
Aufstieg	MALE
Aufstiegs-	MALE
Aufstiegschancen	MALE
Aufstiegsfortbildung	MALE
Aufstockung	MALE
Auftakt	MALE
Auftaktgespräch	MALE
Auftaktveranstaltung	MALE
Auftauwasser	MALE
Aufteilung	MALE
Auftrag	MALE
Auftrageingang	MALE
Auftraggeber	MALE
Auftragnehmer	MALE
Auftragsbestand	MALE
Auftragsbestätigung	MALE
Auftragsbuch	MALE
Auftragseingang	MALE
Auftragseingangs-	MALE
Auftragsgutachten	MALE
Auftragslage	MALE
Auftragslisten	MALE
Auftragsvergabe	MALE
Auftragsverhalten	MALE
Auftragsvolumen	MALE
Auftragswerk	MALE
Auftragswert	MALE
Auftreten	MALE
Auftrieb	MALE
Auftriebskraft	MALE
Auftritt	MALE
Aufwand	MALE
Aufwandsentschädigung	MALE
Aufweichung	MALE
Aufwendung	MALE
Aufwertung	MALE
Aufwuchsfähigkeit	MALE
Aufwärmen	MALE
Aufwärmrunden	MALE
Aufwärtsbewegung	MALE
Aufwärtstrend	MALE
Aufzeichnung	MALE
Aufzucht	MALE
Aufzug	MALE
Aufzügefabrik	MALE
Aug.	MALE
Auge	MALE
Augenarzt	MALE
Augenblick	MALE
Augenblicksidee	MALE
Augenbraue	MALE
Augenhöhe	MALE
Augenmaß	MALE
Augenmerk	MALE
Augenschein	MALE
Augenzeuge	MALE
Augenzeugenbericht	MALE
Augenzwinkern	MALE
August	MALE
Augusthälfte	MALE
Ausbildungszeit	FEMALE
Ausbildungszentrum	FEMALE
Ausbildungszins	FEMALE
Ausblick	FEMALE
Ausbreitung	FEMALE
Ausbruch	FEMALE
Ausbürgerung	FEMALE
Auschwitzleugnung	FEMALE
Ausdehnung	FEMALE
Ausdruck	FEMALE
Ausdrucksform	FEMALE
Ausdrucksweise	FEMALE
Ausdünnung	FEMALE
Auseinandersetzung	FEMALE
Ausfall	FEMALE
Ausflaggung	FEMALE
Ausflug	FEMALE
Ausflugsangebot	FEMALE
Ausflugsboot	FEMALE
Ausflugsdampfer	FEMALE
Ausflugsfahrten	FEMALE
Ausflugsmöglichkeit	FEMALE
Ausflugspaket	FEMALE
Ausflugsprogramm	FEMALE
Ausflugsziel	FEMALE
Ausflügler	FEMALE
Ausfuhrauftrag	FEMALE
Ausfuhrbürgschaft	FEMALE
Ausfuhrgarantie	FEMALE
Ausfuhrgenehmigung	FEMALE
Ausfuhrüberschuß	FEMALE
Ausführlichkeit	FEMALE
Ausführung	FEMALE
Ausführungsbestimmung	FEMALE
Ausfüllen	FEMALE
Ausgabe	FEMALE
Ausgabeaufschlag	FEMALE
Ausgabefach	FEMALE
Ausgabegerät	FEMALE
Ausgabekurs	FEMALE
Ausgabenbegrenzung	FEMALE
Ausgabendynamik	FEMALE
Ausgabenentwicklung	FEMALE
Ausgabengrenze	FEMALE
Ausgabenkürzung	FEMALE
Ausgabenobergrenze	FEMALE
Ausgabenprogramm	FEMALE
Ausgabenrichtgröße	FEMALE
Ausgabenseite	FEMALE
Ausgabepreis	FEMALE
Ausgang	FEMALE
Ausgangsbasis	FEMALE
Ausgangsbedingung	FEMALE
Ausgangsbereich	FEMALE
Ausgangsbestand	FEMALE
Ausgangslage	FEMALE
Ausgangsposition	FEMALE
Ausgangspunkt	FEMALE
Ausgangssituation	FEMALE
Ausgeglichenheit	FEMALE
Ausgestaltung	FEMALE
Ausgewogenheit	FEMALE
Ausgiebigkeit	FEMALE
Ausgleich	FEMALE
Ausgleichsabgabe	FEMALE
Ausgleichsanspruch	FEMALE
Ausgleichsforderung	FEMALE
Ausgleichszahlung	FEMALE
Ausgliederung	FEMALE
Ausgrabung	FEMALE
Ausgrenzung	FEMALE
Ausgrenzungsmechanismus	FEMALE
Ausgrenzungspolitik	FEMALE
Aushang	FEMALE
Aushändigung	FEMALE
Aushängeschild	FEMALE
Aushöhlung	FEMALE
Aushöhlungsprozeß	FEMALE
Ausklammerung	FEMALE
Auskunft	FEMALE
Auskunft	FEMALE
Auskunftsanspruch	FEMALE
Auskunftserteilung	FEMALE
Auskunftspflicht	FEMALE
Ausland	FEMALE
Auslands-	FEMALE
Auslandsamt	FEMALE
Auslandsanteil	FEMALE
Auslandsaufenthalt	MALE
Auslandsauftrag	MALE
Auslandsbank	MALE
Auslandsbeteiligung	MALE
Auslandsbeziehung	MALE
Auslandseinsatz	MALE
Auslandsgeschäft	MALE
Auslandshilfe	MALE
Auslandsinvestition	MALE
Auslandsinvestor	MALE
Auslandskapital	MALE
Auslandskunde	MALE
Auslandskundschaft	MALE
Auslandskäufe	MALE
Auslandsleistung	MALE
Auslandsmarkt	MALE
Auslandsnetz	MALE
Auslandsniederlassung	MALE
Auslandsopposition	MALE
Auslandspartner	MALE
Auslandspresse	MALE
Auslandsredaktion	MALE
Auslandsreise	MALE
Auslandsschuld	MALE
Auslandsschutzbrief	MALE
Auslandssprecher	MALE
Auslandsstudium	MALE
Auslandstochter	MALE
Auslandsverbindlichkeit	MALE
Auslandsverbindung	MALE
Auslandsverschuldung	MALE
Auslassung	MALE
Auslastung	MALE
Auslaufen	MALE
Auslaufmodell	MALE
Auslegung	MALE
Ausleihe	MALE
Ausleseprozess	MALE
Ausleserundreise	MALE
Auslieferung	MALE
Auslieferungsantrag	MALE
Auslieferungsbegehren	MALE
Auslieferungsgefängnis	MALE
Auslieferungsklage	MALE
Auslieferungsverfahren	MALE
Auslobung	MALE
Auslosung	MALE
Ausländer	FEMALE
Ausländeranteil	FEMALE
Ausländeranteils	FEMALE
Ausländerbeauftragte	FEMALE
Ausländerbehörde	MALE
Ausländerfahranteil	MALE
Ausländerfeindlichkeit	FEMALE
Ausländerfrage	MALE
Ausländergesetz	FEMALE
Ausländerin	MALE
Ausländerkind	MALE
Ausländerkriminalität	MALE
Ausländerorganisationen	FEMALE
Ausländerpfarrer	MALE
Ausländerpolitik	MALE
Ausländerrecht	FEMALE
Auslöser	MALE
Ausmaß	MALE
Ausnahme	MALE
Ausnahmefall	MALE
Ausnahmegenehmigung	MALE
Ausnahmegesetz	MALE
Ausnahmeregelung	MALE
Ausnahmezustand	MALE
Ausnutzung	MALE
Ausnüchterung	MALE
Auspeitschung	MALE
Ausplünderung	MALE
Ausprägung	MALE
Auspuffhöhe	MALE
Ausreisesteuer	MALE
Ausreißer	MALE
Ausrichter	MALE
Ausrichtung	MALE
Ausrottung	MALE
Ausrufezeichen	MALE
Ausrufung	MALE
Ausruhen	MALE
Ausrutscher	MALE
Ausrüstung	MALE
Ausrüstungsgegenstand	MALE
Ausrüstungsinvestition	MALE
Aussage	FEMALE
Aussage	MALE
Aussagekraft	FEMALE
Aussageverhalten	FEMALE
Aussageverpflichtung	FEMALE
Aussagewert	FEMALE
Ausschalten	FEMALE
Ausschaltung	FEMALE
Ausschank	FEMALE
Ausscheiden	FEMALE
Ausschließlichkeit	FEMALE
Ausschluss	FEMALE
Ausschlussfrist	FEMALE
Ausschlusstermin	FEMALE
Ausschlußantrag	FEMALE
Ausschlußgrund	FEMALE
Ausschnitt	FEMALE
Ausschreibung	FEMALE
Ausschreibungsbedingungen	FEMALE
Ausschreibungsunterlagen	FEMALE
Ausschreitung	FEMALE
Ausschuss	FEMALE
Ausschussmitglied	FEMALE
Ausschusssprecher	FEMALE
Ausschussvorsitzende	FEMALE
Ausschussvotum	FEMALE
Ausschußmitglied	FEMALE
Ausschüttung	FEMALE
Aussendienstkoffer	FEMALE
Aussenhandelsausschuss	FEMALE
Aussenhandelsüberschusses	FEMALE
Aussenkabine	FEMALE
Aussenkante	FEMALE
Aussenministern	FEMALE
Aussenorganisation	FEMALE
Aussenstehenden	FEMALE
Ausserachtlassung	FEMALE
Aussicht	FEMALE
Aussichtspunkt	FEMALE
Aussiedler	FEMALE
Ausstand	FEMALE
Ausstattung	FEMALE
Ausstattung	FEMALE
Ausstattungsmerkmal	FEMALE
Ausstattungsvariante	FEMALE
Aussteiger	FEMALE
Aussteller	FEMALE
Ausstellung	FEMALE
Ausstellungsbesucher	FEMALE
Ausstellungseröffnung	FEMALE
Ausstellungsfläche	FEMALE
Ausstellungshalle	FEMALE
Ausstellungskatalog	FEMALE
Ausstellungsleiter	FEMALE
Ausstellungsmacher	FEMALE
Ausstellungsraum	FEMALE
Ausstellungsstück	FEMALE
Ausstellungstück	FEMALE
Ausstieg	FEMALE
Ausstoß	FEMALE
Ausstrahlung	FEMALE
Aussuchen	FEMALE
Aussöhnung	FEMALE
Aussöhnungspolitik	FEMALE
Austausch	FEMALE
Austausch-	FEMALE
Austauschaktion	FEMALE
Austauschdienst	FEMALE
Austauschschüler	FEMALE
Auswahl	FEMALE
Auswahlkriterium	FEMALE
Auswahlverfahren	FEMALE
Auswechselspieler	FEMALE
Ausweichlösung	FEMALE
Ausweichmanöver	FEMALE
Ausweichmöglichkeit	FEMALE
Ausweichreaktion	FEMALE
Ausweichtag	FEMALE
Ausweichtermin	FEMALE
Ausweis	FEMALE
Ausweiskontrolle	FEMALE
Ausweispapier	FEMALE
Ausweisung	FEMALE
Ausweitung	FEMALE
Auswertung	FEMALE
Auswirkung	FEMALE
Auswuchs	FEMALE
Auszehrung	FEMALE
Auszeichnung	FEMALE
Auszug	FEMALE
Auszählung	FEMALE
Auszählungsergebnis	FEMALE
Autarkie	FEMALE
Authentizität	FEMALE
Autismus	FEMALE
Auto	FEMALE
Auto-	FEMALE
Auto-	FEMALE
Auto-	FEMALE
Autoabsatz	FEMALE
Autobahn	FEMALE
Autobahnblockade	FEMALE
Autobahnfahrer	FEMALE
Autobahngebühr	FEMALE
Autobahngegner	FEMALE
Autobahnring	FEMALE
Autobahntrassen	FEMALE
Autobahnübergang	FEMALE
Autobau	FEMALE
Autobauer	FEMALE
Autobiographie	FEMALE
Autobombe	FEMALE
Autobranche	FEMALE
Autodidakt	FEMALE
Autofahren	FEMALE
Autofahrer	FEMALE
Autofahrerin	FEMALE
Autofahrt	FEMALE
Autofeind	FEMALE
Autofertigung	FEMALE
Autofirmengipfel	FEMALE
Autogipfel	FEMALE
Autogramm	FEMALE
Autogramm-	FEMALE
Autohaus	FEMALE
Autohersteller	FEMALE
Autoherstellung	FEMALE
Autohändler	FEMALE
Autoindustrie	FEMALE
Autoinspektion	FEMALE
Autokavalkade	FEMALE
Autokonzern	FEMALE
Autokunde	FEMALE
Außenanlage	FEMALE
Außenantenne	FEMALE
Außenbereich	FEMALE
Außenbeziehung	FEMALE
Außendienst	FEMALE
Außendienst-	FEMALE
Außenhandelsrat	FEMALE
Außenminister	FEMALE
Außenministerium	FEMALE
Außenpolitik	FEMALE
Außenprüfung	FEMALE
Außenrelief	FEMALE
Außenseite	FEMALE
Außenseiter	FEMALE
Außenstehende	FEMALE
Außenstelle	FEMALE
Außenwand	FEMALE
Außenwelt	FEMALE
Außenwirtschaft	FEMALE
BFH-	MALE
BFH-	MALE
BMW-	MALE
BMW-	MALE
BMW-	MALE
Ballast	MALE
Ballaststoff	MALE
Ballett	MALE
Ballettabend	MALE
Ballettausbildung	MALE
Balletteinlage	MALE
Ballettlehrer	MALE
Ballettunterricht	MALE
Balsam	MALE
Bauchraum	MALE
Bauchredner	MALE
Bauchschmerz	MALE
Bauchspeicheldrüse	MALE
Bauchtanz	MALE
Baudarlehen	MALE
Baudenkmal	MALE
Baumkultur	FEMALE
Baumschutzsatzung	FEMALE
Baumstamm	FEMALE
Baumwolle	FEMALE
Baumwollverarbeitung	FEMALE
Bauordnung	FEMALE
Bauphase	FEMALE
Bauplan	FEMALE
Bauplastik	FEMALE
Bauprojekt	FEMALE
Baurecht	FEMALE
Baureihe	FEMALE
Bauriese	FEMALE
Bauzeit	FEMALE
Bauzulieferer	FEMALE
Bedenkzeit	FEMALE
Bedeutsamkeit	FEMALE
Bedeutung	FEMALE
Bedeutungslosigkeit	FEMALE
Bedienelemente	FEMALE
Bedienerfreundlich	FEMALE
Bedienstet	FEMALE
Bedienteil	FEMALE
Bedienung	FEMALE
Bedienungsanleitung	FEMALE
Bedienungsfehler	FEMALE
Bedingung	FEMALE
Bedingungsrahmen	FEMALE
Befugnis	FEMALE
Befund	FEMALE
Beförderungszeit	FEMALE
Befürchtung	FEMALE
Befürworter	FEMALE
Befürwortern	FEMALE
Begabung	FEMALE
Begebenheit	FEMALE
Begebung	FEMALE
Begegnung	FEMALE
Begegnungsstätte	FEMALE
Begegnungszentrum	FEMALE
Begehren	FEMALE
Begehrlichkeit	FEMALE
Begehung	FEMALE
Begeisterung	FEMALE
Behauptung	FEMALE
Behausung	FEMALE
Behebung	FEMALE
Beheizung	FEMALE
Beherrschung	FEMALE
Beherrschungsvertrag	FEMALE
Behindert	FEMALE
Behindertenarbeit	FEMALE
Behindertenbeauftragter	FEMALE
Behindertenhilfe	FEMALE
Behindertenverband	FEMALE
Behindertenvertreter	FEMALE
Behindertenwerk	FEMALE
Behinderung	FEMALE
Behörde	FEMALE
Behördenrabatt	FEMALE
Beleg	MALE
Belegschaft	MALE
Belegschaftsaktie	MALE
Belegschaftsaktionär	MALE
Belegschaftsgürtel	MALE
Belegschaftsversammlung	MALE
Belegschaftsvertreter	MALE
Belegung	MALE
Belegungsrecht	MALE
Belehrung	MALE
Beleidigung	MALE
Beleihung	MALE
Beleuchtung	MALE
Beleuchtungsanlage	MALE
Belletristik	FEMALE
Bescheinigung	FEMALE
Bescherung	FEMALE
Beschießung	FEMALE
Beschilderung	FEMALE
Beschimpfung	FEMALE
Beschlag	FEMALE
Beschleunigung	FEMALE
Beschleunigungsgebot	FEMALE
Beschluss	FEMALE
Beschlussabteilung	FEMALE
Beschlussempfehlung	FEMALE
Beschlussfassung	FEMALE
Beschlussfähigkeit	FEMALE
Beschlußfassung	FEMALE
Beschlußfassungstext	FEMALE
Beschlußvorlage	FEMALE
Beschneidung	FEMALE
Beschreibung	FEMALE
Beschriftung	FEMALE
Beschränktheit	FEMALE
Beschränkung	FEMALE
Beschuldigung	FEMALE
Beschulung	FEMALE
Beschuss	FEMALE
Beschuß	FEMALE
Beschwerde	FEMALE
Beschwerdeführer	FEMALE
Beschwerdeführerin	FEMALE
Beschwerdegericht	FEMALE
Beschwerderecht	FEMALE
Beschwerdestelle	FEMALE
Beschwerdeverfahren	FEMALE
Beschwörung	FEMALE
Beschäftigungsabsicht	FEMALE
Beschäftigungsausschuß	FEMALE
Beschäftigungsentwicklung	FEMALE
Beschäftigungsfeld	FEMALE
Beschäftigungsgarantie	FEMALE
Beschäftigungsgegenstand	FEMALE
Beschäftigungsinstrument	FEMALE
Beschäftigungskonzept	FEMALE
Beschäftigungslage	FEMALE
Beschäftigungsmöglichkeit	FEMALE
Beschäftigungsperspektive	FEMALE
Beschäftigungspolitik	FEMALE
Beschäftigungsprogramm	FEMALE
Beschäftigungssegment	FEMALE
Beschäftigungssicherung	FEMALE
Beschäftigungsthema	FEMALE
Beschämung	FEMALE
Beseitigung	FEMALE
Besen	FEMALE
Besessenheit	FEMALE
Besetzung	FEMALE
Besichtigung	FEMALE
Besichtigungstour	FEMALE
Besiedlung	FEMALE
Besiegelung	FEMALE
Besinnung	FEMALE
Besitz	FEMALE
Besitzanspruch	FEMALE
Besitzer	FEMALE
Besitzerin	FEMALE
Besitzstruktur	FEMALE
Besitzung	FEMALE
Besitzverhältnis	FEMALE
Besitzwechsel	FEMALE
Besonnenheit	FEMALE
Besorgnis	FEMALE
Besorgung	FEMALE
Bestallung	FEMALE
Bestand	FEMALE
Bestandsaufnahme	FEMALE
Bestandserhaltung	FEMALE
Bestandskraft	FEMALE
Bestandsschutz	FEMALE
Bestandteil	FEMALE
Bestattung	FEMALE
Beste	FEMALE
Bestechlichkeit	FEMALE
Bestechung	FEMALE
Bestechungsaffäre	FEMALE
Bestechungsgeld	FEMALE
Bestechungsskandal	FEMALE
Bestechungsversuch	FEMALE
Besteck	FEMALE
Bestehen	FEMALE
Bestellinformation	FEMALE
Bestellplattform	FEMALE
Bestellschein	FEMALE
Bestelltätigkeit	FEMALE
Bestellung	FEMALE
Bestellungsdekret	FEMALE
Bestellvolumen	FEMALE
Besteuerung	FEMALE
Besteuerungsgrundlage	FEMALE
Bestialität	FEMALE
Bestie	FEMALE
Bestimmtes	FEMALE
Bestimmtheit	FEMALE
Bestimmung	FEMALE
Bestmarke	FEMALE
Bestnote	FEMALE
Bestrafung	FEMALE
Bestrahlung	FEMALE
Bestrebung	FEMALE
Bestrebung	FEMALE
Bestreitung	FEMALE
Bestseller	FEMALE
Bestsellerautor	FEMALE
Bestwert	FEMALE
Bestzeit	FEMALE
Bestätigung	FEMALE
Bestätigungsmail	FEMALE
Bestätigungsrecht	FEMALE
Bestürzung	FEMALE
Besuch	FEMALE
Besucher	FEMALE
Besuchergruppe	FEMALE
Besucherin	FEMALE
Besucherzahl	FEMALE
Besuchsreise	FEMALE
Besuchstermin	FEMALE
Besuchsvorbereitung	FEMALE
Betriebsartumschaltung	FEMALE
Betriebsaufgabe	FEMALE
Betriebsaufspaltung	FEMALE
Betriebsausflug	FEMALE
Betriebsausgabe	FEMALE
Betriebsbesichtigung	FEMALE
Betriebsdauer	FEMALE
Betriebsdruck	FEMALE
Betriebsergebnis	FEMALE
Betriebserkundung	FEMALE
Betriebserlaubnis	FEMALE
Betriebsferien	FEMALE
Betriebsfest	FEMALE
Betriebsfähigkeit	FEMALE
Betriebsführung	FEMALE
Betriebsgenehmigung	FEMALE
Betriebsgesellschaft	FEMALE
Betriebsgewerkschaft	FEMALE
Betriebsgewinn	FEMALE
Betriebsgrösse	FEMALE
Betriebshof	FEMALE
Betriebsinhaber	FEMALE
Betriebsjahr	FEMALE
Betriebsklima	FEMALE
Betriebskommission	FEMALE
Betriebskommunikation	FEMALE
Betriebskommunikationsseminar	FEMALE
Betriebskonzept	FEMALE
Betriebskosten	FEMALE
Betriebskrankenkasse	FEMALE
Betriebsleiter	FEMALE
Betriebsmittel	FEMALE
Betriebspraktikum	FEMALE
Betriebsprogramm	FEMALE
Betriebsprüfer	FEMALE
Betriebsprüfung	FEMALE
Betriebsrat	FEMALE
Betriebsratsmehrheit	FEMALE
Betriebsratsvorsitzende	FEMALE
Betriebsschließung	FEMALE
Betriebssituation	FEMALE
Betriebsstruktur	FEMALE
Betriebsstätte	FEMALE
Betriebsstörung	FEMALE
Betriebssystem	FEMALE
Betriebssystemuhr	FEMALE
Betriebssystemumgebung	FEMALE
Betriebstemperatur	FEMALE
Betriebsunfall	FEMALE
Betriebsurlaub	FEMALE
Betriebsvereinbarung	FEMALE
Betriebsverfassungsgesetz	FEMALE
Betriebsvermögen	FEMALE
Betriebsversammlung	FEMALE
Betriebswirt	FEMALE
Betriebswirtschaft	FEMALE
Betriebswirtschaftler	FEMALE
Betriebswirtschaftslehre	FEMALE
Betriebszeit	FEMALE
Betriebszugehörigkeit	FEMALE
Betriebsänderung	FEMALE
Betriebsübergang	FEMALE
Betroffen	FEMALE
Betroffenheit	FEMALE
Beweis	MALE
Beweis	MALE
Beweisaufnahme	MALE
Beweisführung	MALE
Beweislage	MALE
Beweislast	MALE
Beweismaterial	MALE
Beweismittel	MALE
Beweisort	MALE
Beweisstück	MALE
Beweiswürdigung	MALE
Bewerber	MALE
Bewerberin	MALE
Bewerbung	MALE
Bewerbungsausschluss	MALE
Bewerbungsfrist	MALE
Bewerbungsunterlage	MALE
Bewerbungsverfahren	MALE
Bewertung	MALE
Bewertungsbedarf	MALE
Bewertungsfeld	MALE
Bewertungsklasse	MALE
Bewertungskriterium	MALE
Bewertungssystem	MALE
Bewilligung	MALE
Bewirtschaftung	MALE
Bewirtung	MALE
Bewohnbarkeit	MALE
Bewohner	MALE
Bewohnerin	MALE
Bewunderung	MALE
Bewusstlosigkeit	MALE
Bewusstsein	MALE
Bewußtlosigkeit	MALE
Bewußtseinsindustrie	MALE
Bewußtseinswandel	MALE
Bewässerungsanlage	MALE
Bewässerungsgraben	MALE
Bexbacher	MALE
Bezahlung	MALE
Bezeichnung	MALE
Bezichtigung	MALE
Beziehung	MALE
Beziehungsgeflecht	MALE
Bezirk	MALE
Bezirksamt	MALE
Bezirksgericht	MALE
Bezirksliga	MALE
Bezirkspersonalräten	MALE
Bezirksrat	MALE
Bezirksregierung	MALE
Bezirkssportanlage	MALE
Bezirksvertretung	MALE
Bezirksvorsteher	MALE
Bezug	MALE
Bezugnahme	MALE
Bezugsgröße	MALE
Bezugsmöglichkeit	MALE
Bezugsperson	MALE
Bezugspunkt	MALE
Bezugsrahmen	MALE
Bezugsrecht	MALE
Bezugsrechtehandel	MALE
Bezugsseite	MALE
Bezugssystem	MALE
Bindestrich	MALE
Bindestrich	MALE
Bindung	MALE
Bindungswirkung	MALE
Bluff	FEMALE
Blutzucker	MALE
Blutzuckerspiegel	MALE
Blödelei	MALE
Blümchenkissen	MALE
Blütentraum	MALE
Blütezeit	FEMALE
Bmw-	MALE
Board	MALE
Bonn	MALE
Bonus	MALE
Bonusmaterial	MALE
Bonze	MALE
Brand	MALE
Brandanschlag	MALE
Brandbeschleuniger	MALE
Bratwurst	FEMALE
Brauch	FEMALE
Brauchbarkeit	FEMALE
Brauchtum	FEMALE
Brauchwassernutzung	FEMALE
Brauerei	FEMALE
Brauhaus	FEMALE
Brauindustrie	FEMALE
Braunkohle	FEMALE
Braunkohlemeiler	FEMALE
Braunkohlerevier	FEMALE
Brennstoff	MALE
Brennstoffzelle	MALE
Brennweite	MALE
Bronzezeit	FEMALE
Brummi	FEMALE
Brunch	FEMALE
Brunchen	FEMALE
Brühe	FEMALE
Brünnlein	FEMALE
Busfahrer	MALE
Busfahrt	MALE
Bush-	MALE
Bushaltestelle	MALE
Bushaltestellen	MALE
Business	MALE
Business-	MALE
Businesspraxis	MALE
Buslinie	MALE
Buspendeldienst	MALE
Busreise	MALE
Busrundreise	MALE
Catania	MALE
Champagner	MALE
Champagnerband	MALE
Chemikalie	FEMALE
Chemikalienfabrik	FEMALE
Chemiker	FEMALE
Chemikerin	FEMALE
Cognac	MALE
Curry	MALE
Cursor	MALE
D-	FEMALE
D-	FEMALE
DM	FEMALE
Dach	FEMALE
Damenwahl	FEMALE
Damm	FEMALE
Dampf	MALE
Dampfbad	MALE
Dampfer	MALE
Dampferfahrt	MALE
Dampflokomotiven	MALE
Dampfmaschine	MALE
Dampfwalze	MALE
Dampfzug	MALE
Dekadenz	FEMALE
Dekan	FEMALE
Dekanat	FEMALE
Dekanatsratssitzung	FEMALE
Dekanin	FEMALE
Deklaration	FEMALE
Dekonstruktion	FEMALE
Dekoration	FEMALE
Dekret	FEMALE
Deutschunterricht	MALE
Deutung	MALE
Deutungsmuster	MALE
Deutungsmöglichkeit	MALE
Dhabi	MALE
Dienstag	MALE
Dienstagabend	MALE
Dienstagmorgen	MALE
Dienstagstermin	MALE
Dienstalter	MALE
Dienstaltersstufe	MALE
Dienstanbieter	MALE
Dienstanweisung	MALE
Dienstauto	MALE
Dienstbehörde	MALE
Dienstbericht	MALE
Dienstbesprechung	MALE
Dienstbezug	MALE
Diensteinteiler	MALE
Dienstgeber	MALE
Dienstgruppenleiter	MALE
Diensthabend	MALE
Dienstherr	MALE
Dienstkalender	MALE
Dienstleister	MALE
Dienstleistung	MALE
Dienstleistungsabend	MALE
Dienstleistungsangebot	MALE
Dienstleistungsarbeitsplatz	MALE
Dienstleistungsbereich	MALE
Dienstleistungsbranche	MALE
Dienstleistungsgesellschaft	MALE
Dienstleistungsgewerkschaft	MALE
Dienstleistungsmetropole	MALE
Dienstleistungssektor	MALE
Dienstleistungssparte	MALE
Dienstleistungstochter	MALE
Dienstleistungsunternehmen	MALE
Dienstleiter	MALE
Dienstmädchen	MALE
Dienstordnungsverfahren	MALE
Dienstplan	MALE
Dienstrecht	MALE
Dienstrechtsreform	MALE
Dienstreise	MALE
Dienstschluss	MALE
Dienststelle	MALE
Dienststellenleitung	MALE
Dienststunde	MALE
Dienstvereinbarung	MALE
Dienstverhältnis	MALE
Dienstvertrag	MALE
Dienstverweigerung	MALE
Dienstvorschrift	MALE
Dienstwagen	MALE
Dienstwohnung	MALE
Dienstzeit	FEMALE
Dienstzimmer	FEMALE
Dill	MALE
Dimensionierung	FEMALE
Ding	MALE
Dingsbums	MALE
Diskretion	FEMALE
Diskriminierung	FEMALE
Diskrimminierungsverbot	FEMALE
Diskurs	FEMALE
Diskursmarker	FEMALE
Diskussion	FEMALE
Diskussionsbedarf	FEMALE
Diskussionsbeitrag	FEMALE
Diskussionsforum	FEMALE
Diskussionsgrundlage	FEMALE
Diskussionsmöglichkeit	FEMALE
Diskussionsprozeß	FEMALE
Diskussionsrunde	FEMALE
Diskussionsstoff	FEMALE
Diskussionsthema	FEMALE
Diskussionsveranstaltung	FEMALE
Doktor	MALE
Doktorand	MALE
Doktorandentreffen	MALE
Doktorarbeit	MALE
Doktrin	MALE
Dollar	MALE
Dolmetscher	MALE
Domplatz	MALE
Donnerstag	MALE
Donnerstagabend	MALE
Donnerwetter	MALE
Dreharbeit	FEMALE
Drehbuch	FEMALE
Drehbuchautor	FEMALE
Drehbuchpreis	FEMALE
Drehen	FEMALE
Drehklappe	FEMALE
Drehleier	FEMALE
Drehmaschinenhersteller	FEMALE
Drehmoment	FEMALE
Drehrestaurant	FEMALE
Drehrichtung	FEMALE
Drehscheibe	FEMALE
Drehstromlokomotive	FEMALE
Drehtür	FEMALE
Drehung	FEMALE
Drehzahl	FEMALE
Drehzahlgeber	FEMALE
Drei-	FEMALE
Drei-	FEMALE
Drei-	FEMALE
Drei-	FEMALE
Drei-	FEMALE
Drei-	FEMALE
Drei-	FEMALE
Drei-	FEMALE
Drei-	FEMALE
Drei-	FEMALE
Drei-	FEMALE
Drei-	FEMALE
Drei-	FEMALE
Drei-	FEMALE
Dreibund	FEMALE
Druckfarbe	FEMALE
Druckformat	FEMALE
Druckgeschwindigkeit	FEMALE
Druckgewerkschaft	FEMALE
Druckindustrie	FEMALE
Druckjob	FEMALE
Druckkopf	FEMALE
Druckkosten	FEMALE
Druckluft	FEMALE
Druckmaschine	FEMALE
Druckmaschinenhersteller	FEMALE
Druckmedium	FEMALE
Druckmittel	FEMALE
Druckplatte	FEMALE
Druckpotential	FEMALE
Druckqualität	FEMALE
Druckrichtung	FEMALE
Drucksache	FEMALE
Druckschriftensatz	FEMALE
Drucksparte	FEMALE
Drucktaste	FEMALE
Drucktechnologie	FEMALE
Drucktempo	FEMALE
Druckversion	FEMALE
Druckvorstufenbranche	FEMALE
Druckvorstufenunternehmen	FEMALE
Druckwasserreaktor	FEMALE
Druckwegoptimierung	FEMALE
Druide	FEMALE
Drumherumgerede	FEMALE
Drüse	FEMALE
EM	FEMALE
EM-	FEMALE
EM-	FEMALE
Echtzeit	FEMALE
Eck	FEMALE
Eckdatum	FEMALE
Ecke	FEMALE
Edelstahl	MALE
Edelstein	MALE
Edelweiß	MALE
Eifersucht	FEMALE
Eigentumsvorbehalt	MALE
Eigentumswohnung	MALE
Eigentümerfamilie	MALE
Eigenverantwortlichkeit	MALE
Eigenverantwortung	MALE
Eignerfamilie	MALE
Eignung	MALE
Eignungsprüfung	MALE
Eindruck	MALE
Einengung	MALE
Einfachheit	MALE
Einfahrt	MALE
Einfallsreichtum	MALE
Einflussnahme	FEMALE
Einflußfaktor	FEMALE
Einflußgebiet	FEMALE
Einflußmöglichkeit	FEMALE
Einflußnahme	FEMALE
Einflußnahmen	FEMALE
Einfuhr	FEMALE
Einfuhrbeschränkung	FEMALE
Einfärbung	MALE
Einfügung	FEMALE
Einfühlsamkeit	FEMALE
Einfühlungsvermögen	FEMALE
Einführung	FEMALE
Einführungskurs	FEMALE
Einführungslektion	FEMALE
Einführungssprachkurs	FEMALE
Eingabe	FEMALE
Eingabegerät	FEMALE
Eingabewert	FEMALE
Eingang	FEMALE
Eingangfrequenz	FEMALE
Eingangsbereich	FEMALE
Eingangsbuchse	FEMALE
Eingangshalle	FEMALE
Eingangspuffer	FEMALE
Eingangsraum	FEMALE
Eingangssatz	FEMALE
Eingangsschild	FEMALE
Eingangsspannung	FEMALE
Eingangstür	FEMALE
Eingangsuntersuchung	FEMALE
Eingeboren	FEMALE
Eingemeindung	FEMALE
Eingeständnis	FEMALE
Eingliederung	FEMALE
Eingliederungshilfe	FEMALE
Eingreiftruppe	FEMALE
Eingrenzung	FEMALE
Eingriff	FEMALE
Einhaltung	FEMALE
Einheimisch	FEMALE
Einheit	FEMALE
Einheitlichkeit	FEMALE
Einheitswert	FEMALE
Einheitswährung	FEMALE
Einholung	FEMALE
Einigkeit	FEMALE
Einigung	FEMALE
Einigungschance	FEMALE
Einigungsstelle	FEMALE
Einigungsvertrag	FEMALE
Einigungswerk	FEMALE
Einigungswille	FEMALE
Einjährig	FEMALE
Einkauf	FEMALE
Einkaufen	FEMALE
Einkaufs-	FEMALE
Einkaufschef	FEMALE
Einkaufsdelegation	FEMALE
Einkaufsdienst	FEMALE
Einkaufsmitarbeiter	FEMALE
Einkaufsmöglichkeit	FEMALE
Einkaufsparadies	FEMALE
Einkaufspassage	FEMALE
Einkaufssparte	FEMALE
Einkaufsstraße	FEMALE
Einkaufstour	FEMALE
Einkaufsvereinbarung	FEMALE
Einkaufsviertel	FEMALE
Einkaufswagen	FEMALE
Einkaufswochenende	FEMALE
Einkaufszentrum	FEMALE
Einkaufzentrum	FEMALE
Einkerkerung	FEMALE
Einkesselung	FEMALE
Einklang	FEMALE
Einkommen	FEMALE
Einkommensanpassung	FEMALE
Einkommensgrenze	FEMALE
Einkommensgrenzen	FEMALE
Einkommensgruppe	FEMALE
Einkommenslimits	FEMALE
Einkommensskala	FEMALE
Einkommenssteigerung	FEMALE
Einkommenssteuererklärung	FEMALE
Einkommensteuer	FEMALE
Einkommensteuerbescheid	FEMALE
Einkommensteuererklärung	FEMALE
Einkommensteuergesetz	FEMALE
Einkommensteuerrecht	FEMALE
Einkommensteuersatz	FEMALE
Einkommensumverteilung	FEMALE
Einkommensverhältnis	FEMALE
Einkommensverlust	FEMALE
Einkommensverteilung	FEMALE
Einkunft	FEMALE
Einkunft	FEMALE
Einkunftsart	FEMALE
Einkunftsquelle	FEMALE
Einladung	FEMALE
Einlage	FEMALE
Einlass	FEMALE
Einlassung	FEMALE
Einlegung	FEMALE
Einleitung	FEMALE
Einlösung	FEMALE
Einmaligkeit	FEMALE
Einmalzahlung	FEMALE
Einmündung	FEMALE
Einnahme	FEMALE
Einnahmeeinbuße	FEMALE
Einnahmeprognose	FEMALE
Einnahmequelle	FEMALE
Einnahmeverlust	FEMALE
Einparteienherrschaft	FEMALE
Einparteiensystem	FEMALE
Einquartierung	FEMALE
Einreichung	FEMALE
Einreichungsschluss	FEMALE
Einreisebestimmung	FEMALE
Einreisedatum	FEMALE
Einreisedokument	FEMALE
Einreiseformalität	FEMALE
Einreisekarte	FEMALE
Einreiseverweigerung	FEMALE
Einrichtung	FEMALE
Einrichtungsgegenstand	FEMALE
Einrichtungshaus	FEMALE
Einsamkeit	FEMALE
Einsammeln	FEMALE
Einsammlung	FEMALE
Einsatz	FEMALE
Einsatzbereitschaft	FEMALE
Einsatzfeld	FEMALE
Einsatzgebiet	FEMALE
Einsatzkraft	FEMALE
Einsatzleiter	FEMALE
Einsatzleitung	FEMALE
Einsatzmittel	FEMALE
Einsatzmöglichkeit	FEMALE
Einsatzort	FEMALE
Einsatzplan	FEMALE
Einsatzregel	FEMALE
Einsatztruppe	FEMALE
Einsatzzweck	FEMALE
Einschalten	FEMALE
Einschaltquote	FEMALE
Einschaltung	FEMALE
Einschnitt	FEMALE
Einschreibung	FEMALE
Einschreibungsentscheidung	FEMALE
Einschränkung	FEMALE
Einschätzung	FEMALE
Einschätzung	FEMALE
Einschüchterung	FEMALE
Einschüchterungsversuch	FEMALE
Einseitigkeit	FEMALE
Einsender	FEMALE
Einsendeschluss	FEMALE
Einsendung	FEMALE
Einsicht	FEMALE
Einsichtnahme	FEMALE
Einsortierung	FEMALE
Einsparpotential	FEMALE
Einsparung	FEMALE
Einsparungsberater	FEMALE
Einspielung	FEMALE
Einspruch	FEMALE
Einspruchsentscheidung	FEMALE
Einspruchsflut	FEMALE
Einspruchsverfahren	FEMALE
Einstand	FEMALE
Einstandskosten	FEMALE
Einstandspreis	FEMALE
Einsteckbaugruppe	FEMALE
Einsteckkarte	FEMALE
Einsteigertarif	FEMALE
Einstellreihenfolge	FEMALE
Einstellschritt	FEMALE
Einstellung	FEMALE
Einstellungskriterium	FEMALE
Einstellungsstopp	FEMALE
Einstichstelle	FEMALE
Einstieg	FEMALE
Einstiegsbild	FEMALE
Einstiegsgehalt	FEMALE
Einstimmigkeit	FEMALE
Einstimmung	FEMALE
Einstudierung	FEMALE
Einstufung	FEMALE
Einsturz	FEMALE
Einteilung	FEMALE
Eintracht	FEMALE
Eintracht-	FEMALE
Eintracht-	FEMALE
Eintracht-	FEMALE
Eintrachtspieler	FEMALE
Eintrag	FEMALE
Eintragung	FEMALE
Eintreibung	FEMALE
Eintritt	FEMALE
Eintrittsgebühr	FEMALE
Eintrittsgeld	FEMALE
Eintrittsgelder	FEMALE
Eintrittskarte	FEMALE
Eintrittspreis	FEMALE
Einundachtzigjährig	FEMALE
Einunddreißigjährig	FEMALE
Einundfünfzigjährig	FEMALE
Einundneunzigjährig	FEMALE
Einundsechzigjährig	FEMALE
Einundsiebzigjährig	FEMALE
Einundvierzigjährig	FEMALE
Einundzwanzigjährig	FEMALE
Einvernehmen	FEMALE
Einverständniserklärung	FEMALE
Einwand	FEMALE
Einwand	FEMALE
Einwand	FEMALE
Einwanderer	FEMALE
Einwanderergeneration	FEMALE
Einwanderungsgesetz	FEMALE
Einwanderungsland	FEMALE
Einwanderungspolitik	FEMALE
Einwegprodukt	FEMALE
Einwegsteuer	FEMALE
Einweihung	FEMALE
Einwilligung	FEMALE
Einwirkung	FEMALE
Einwohner	FEMALE
Einwohnerin	FEMALE
Einwohnerregister	FEMALE
Einwohnerzahl	FEMALE
Einzahl	FEMALE
Einzel	FEMALE
Einzel-	FEMALE
Einzelamerikaner	FEMALE
Einzelauftrag	FEMALE
Einzelbeobachtung	FEMALE
Einzelblatt	FEMALE
Einzelblattzufuhrschlitz	FEMALE
Einzelfall	FEMALE
Einzelfallprüfung	FEMALE
Einzelfrage	FEMALE
Einzelgänger	FEMALE
Einzelhandel	FEMALE
Einzelhandelskette	FEMALE
Einzelhandelskonzern	FEMALE
Einzelhandelsvertreterin	FEMALE
Einzelhaushalt	FEMALE
Einzelheit	FEMALE
Einzelhändler	FEMALE
Einzelinvestor	FEMALE
Einzelkämpfer	FEMALE
Einzelmaßnahme	FEMALE
Einzelmodul	FEMALE
Einzelperson	FEMALE
Einzelpflanze	FEMALE
Einzelplan	FEMALE
Einzelprojekt	FEMALE
Einzelreisebüro	FEMALE
Einzelrichter	FEMALE
Einzelstaat	FEMALE
Einzelteil	FEMALE
Einzeltermin	FEMALE
Einzeltäter	FEMALE
Einzelunternehmen	FEMALE
Einzelunterricht	MALE
Einzelveranstaltung	MALE
Einzelverfahren	MALE
Einzelvertrag	MALE
Einzelwertung	MALE
Einzelzahl	MALE
Einzelzimmer	MALE
Einzelzimmerzuschlag	MALE
Einziehung	MALE
Einzigartigkeit	MALE
Einzugsbereich	MALE
Einzugsgebiet	MALE
Einzäunung	FEMALE
Einübung	FEMALE
Eis-	MALE
Eis-	MALE
Eis-	MALE
Eiszeit	FEMALE
Eleganz	FEMALE
Eleganzverweigerung	FEMALE
Elektriker	FEMALE
Elektrizität	FEMALE
Elektrizitätserzeuger	FEMALE
Elektrizitätsgesellschaft	FEMALE
Elektrizitätsunternehmen	FEMALE
Elektrizitätswerk	FEMALE
Elektro-	FEMALE
Elektro-	FEMALE
Elektroanlagenbauer	FEMALE
Elektroauto	FEMALE
Elektrobranche	FEMALE
Elternarbeit	FEMALE
Elternbeirat	FEMALE
Elternbeiratssitzung	FEMALE
Elternhaus	FEMALE
Elternschaft	FEMALE
Elternteil	FEMALE
Elternverein	FEMALE
Elternvorwurf	FEMALE
Elternwunsch	FEMALE
Elternzeit	FEMALE
Email	FEMALE
Email-	FEMALE
Emailadresse	FEMALE
Emailschild	FEMALE
Empathie	FEMALE
Empfehlung	FEMALE
Empfindlichkeit	FEMALE
Empfindung	FEMALE
Empfindung	FEMALE
Empfänglichkeit	FEMALE
Empirie	FEMALE
Empirismus	FEMALE
Empörung	FEMALE
Empörung	FEMALE
Endzeit	FEMALE
Endziel	FEMALE
Energie	FEMALE
Energieagentur	FEMALE
Energiebedarf	FEMALE
Energieberater	FEMALE
Energieberatung	FEMALE
Energieberatungsservice	FEMALE
Energieeffizienz	FEMALE
Energieeinsparpotential	FEMALE
Energieeinsparung	FEMALE
Energieerzeugung	FEMALE
Energiegewinnung	FEMALE
Energiekonsens	FEMALE
Energiekonzern	FEMALE
Energiekoste	FEMALE
Energiekostenabrechnung	FEMALE
Energiemarkt	FEMALE
Energieministerium	FEMALE
Energieplan	FEMALE
Energiepolitik	FEMALE
Energiepreis	FEMALE
Energieprojekt	FEMALE
Energiequelle	FEMALE
Energierechnung	FEMALE
Energierecht	FEMALE
Energiesparangebot	FEMALE
Energiesparen	FEMALE
Energiesparlampe	FEMALE
Energiesparmaßnahme	FEMALE
Energiespeicher	FEMALE
Energiesteuer	FEMALE
Energiestrategie	FEMALE
Energiesystem	FEMALE
Energietechnik	FEMALE
Energieträger	FEMALE
Energieunternehmen	FEMALE
Energieverbrauch	FEMALE
Energieverlust	FEMALE
Energieverschwender	FEMALE
Energieverschwendung	FEMALE
Energieversorger	FEMALE
Energieversorgung	FEMALE
Energieversorgungsunternehmen	FEMALE
Energiewende	FEMALE
Energiewerk	FEMALE
Energiewirtschaft	FEMALE
Energiewirtschaftsgesetz	FEMALE
England	MALE
England-	MALE
Englandbesuch	MALE
Englisch	MALE
Englische	MALE
Englischkenntnis	MALE
Englischlehrer	MALE
Englischunterricht	MALE
Engpass	MALE
Engstirnigkeit	MALE
Entstehungszeit	FEMALE
Enttäuschung	FEMALE
Entwaffnung	FEMALE
Entwarnung	FEMALE
Entwertung	FEMALE
Entwickler	FEMALE
Entwicklung	FEMALE
Entwicklungsabkommen	FEMALE
Entwicklungsabteilung	FEMALE
Entwicklungsaktivität	FEMALE
Entwicklungsarbeit	FEMALE
Entwicklungsaufwand	FEMALE
Entwicklungschance	FEMALE
Entwicklungschef	FEMALE
Entwicklungsgeschichte	FEMALE
Entwicklungsgesellschaft	FEMALE
Entwicklungshelfer	FEMALE
Entwicklungshilfe	FEMALE
Entwicklungshilfe-	FEMALE
Entwicklungshilfeministerium	FEMALE
Entwicklungsland	FEMALE
Entwicklungsleistung	FEMALE
Entwicklungslinie	FEMALE
Entwicklungsministerium	FEMALE
Entwicklungsmöglichkeit	FEMALE
Entwicklungsorganisation	FEMALE
Entwicklungsperspektive	FEMALE
Entwicklungsphase	FEMALE
Entwicklungspolitik	FEMALE
Entwicklungsprogramm	FEMALE
Entwicklungsprojekt	FEMALE
Entwicklungsprozess	FEMALE
Entwicklungspsychologie	FEMALE
Entwicklungsschritt	FEMALE
Entwicklungsstand	FEMALE
Entwicklungsstufe	FEMALE
Entwicklungstendenz	FEMALE
Entwicklungszeit	FEMALE
Entwicklungszentrum	FEMALE
Entwicklungszusammenarbeit	FEMALE
Entwurf	FEMALE
Entwässerung	FEMALE
Entwässerungssystem	FEMALE
Entwöhnung	FEMALE
Entzauberung	FEMALE
Entziehung	FEMALE
Entzug	FEMALE
Entzugserscheinung	FEMALE
Entzugssymptom	FEMALE
Entzündung	FEMALE
Environment	FEMALE
Epilepsie	FEMALE
Epileptiker	FEMALE
Epilog	FEMALE
Epinayplatz	FEMALE
Erdgas	MALE
Erdgasauto	MALE
Erdgashandel	MALE
Erdgasumstellungskosten	MALE
Erdgasvorkommen	MALE
Erdgeschoss	MALE
Erdgipfel	MALE
Erdkruste	MALE
Erfahrung	FEMALE
Erfahrungsaustausch	FEMALE
Erfahrungsbericht	FEMALE
Erfahrungspunkt	FEMALE
Erfahrungswert	FEMALE
Erfahungsschatz	FEMALE
Erfassung	FEMALE
Erfinder	FEMALE
Erfindung	FEMALE
Erfolg	FEMALE
Erfolg	MALE
Erfolglosigkeit	MALE
Erfolgsaussicht	MALE
Erfolgsbeispiel	MALE
Erfolgschance	MALE
Erfolgserlebnis	MALE
Erfolgsfaktor	MALE
Erfolgsgeheimnis	MALE
Erfolgsgeschichte	MALE
Erfolgskontrolle	MALE
Erfolgskurs	MALE
Erfolgsmeldung	MALE
Erfolgsmensch	MALE
Erfolgsmodell	MALE
Erfolgsmuster	MALE
Erfolgsquote	MALE
Erfolgsrechnung	MALE
Erfolgsrezept	MALE
Erfolgssaga	MALE
Erfolgsstory	MALE
Erfolgswelle	MALE
Erforderlichkeit	MALE
Erfordernis	FEMALE
Erfordernis	MALE
Erforschung	FEMALE
Erfrierung	FEMALE
Erfrischung	FEMALE
Erinnerung	FEMALE
Erinnerungsarbeit	FEMALE
Erinnerungskultur	FEMALE
Erinnerungspunkt	FEMALE
Eritreer	FEMALE
Erklärung	FEMALE
Erklärungsansatz	FEMALE
Erklärungsbedarf	FEMALE
Erklärungsgrund	FEMALE
Erkrankung	FEMALE
Erkundigung	FEMALE
Erkundung	FEMALE
Erkundungsgang	FEMALE
Erlangung	FEMALE
Erlass	FEMALE
Erlassregelung	FEMALE
Erlaubnis	FEMALE
Erlaubnispapier	FEMALE
Erlebnis	FEMALE
Erlebnis-	FEMALE
Erlebnisbad	FEMALE
Erlebnisgesellschaft	FEMALE
Erlebnispädagogik	FEMALE
Erlebniswelt	FEMALE
Erledigung	FEMALE
Erleichterung	FEMALE
Erläuterung	FEMALE
Erwartung	FEMALE
Erwartungshaltung	FEMALE
Erweckung	FEMALE
Erweiterung	FEMALE
Erweiterungsbauhotel	FEMALE
Erweiterungsbedarf	FEMALE
Erweiterungseinheit	FEMALE
Erweiterungsmöglichkeit	FEMALE
Erweiterungsprojekt	FEMALE
Erweiterungssatz	FEMALE
Erwerb	FEMALE
Erwerber	FEMALE
Erwerbsarbeit	FEMALE
Erwerbsfähigkeit	FEMALE
Erwerbsleben	FEMALE
Erwerbslosenzahl	FEMALE
Erwerbslosigkeit	FEMALE
Erwerbsminderung	FEMALE
Erwerbsperson	FEMALE
Erwerbssteuer	FEMALE
Erwerbstätig	FEMALE
Erwerbstätigkeit	FEMALE
Erwerbsvolumen	FEMALE
Erwerbung	FEMALE
Erwiderung	FEMALE
Erwärmung	FEMALE
Erz	FEMALE
Erzbischof	FEMALE
Erzbistum	FEMALE
Erzdiözese	FEMALE
Erzengel	FEMALE
Erzeugerpreis	FEMALE
Erzeugnis	FEMALE
Erzeugung	FEMALE
Erzherzog	FEMALE
Erzieher	FEMALE
Erzieherin	FEMALE
Erziehung	FEMALE
Erziehungsarbeit	FEMALE
Erziehungsberechtigte	FEMALE
Erziehungsberuf	FEMALE
Erziehungsurlaub	MALE
Erziehungswissenschaft	MALE
Erziehungswissenschaftler	MALE
Erzielung	MALE
Erzkonkurrent	MALE
Erzrivale	MALE
Erzwingung	MALE
Erzählerin	FEMALE
Erzählung	FEMALE
Erzählweise	FEMALE
Eröffnungsbeschluß	MALE
Eröffnungsveranstaltung	MALE
Es-	MALE
Espresso	MALE
Espressobar	MALE
Espressostand	MALE
Esprit	MALE
Essay	MALE
Essayist	MALE
Essen	MALE
Essenskasse	MALE
Essensprobe	MALE
Essenszubereitung	MALE
Essgewohnheit	MALE
Essig	MALE
Essigtrinker	MALE
Euro	MALE
Euro-	MALE
Euro-	MALE
Euro-	MALE
Euro-	MALE
Euro-	MALE
Eurobank	MALE
Euroraum	MALE
Euroregion	MALE
Expressionismus	MALE
Expressionist	MALE
Externalisierung	MALE
Externalisierungsstrategie	MALE
Extra-	MALE
Extrabett	MALE
Extraklasse	MALE
Extraschicht	MALE
Extrasendung	MALE
Extravaganz	MALE
Extremfall	MALE
Extremismus	MALE
Extremist	MALE
Extremistengruppe	MALE
Extremität	MALE
Extremsituation	MALE
Extremsportler	MALE
Facharbeit	FEMALE
Facharbeiter	FEMALE
Facharzt	FEMALE
Fachaufsicht	FEMALE
Fachausschuss	FEMALE
Fachbeamter	FEMALE
Fachbegriff	FEMALE
Fachberatung	FEMALE
Fachbereich	FEMALE
Fachbereichsrat	FEMALE
Fachbesucher	FEMALE
Fachbetrieb	FEMALE
Fachbuch	FEMALE
Fachdidaktik	FEMALE
Fachdisziplin	FEMALE
Fachforum	FEMALE
Fachgebiet	FEMALE
Fachgeschäft	FEMALE
Fachgesellschaft	FEMALE
Fachgespräch	FEMALE
Fachgroßhandel	FEMALE
Fachgruppe	FEMALE
Fachhandel	FEMALE
Fachhandelskooperation	FEMALE
Fachhochschule	FEMALE
Fachhochschulreife	FEMALE
Fachhändler	FEMALE
Fachinformation	FEMALE
Fachjournalist	FEMALE
Fachkenntnis	FEMALE
Fachklinik	FEMALE
Fachkollege	FEMALE
Fachkompetenz	FEMALE
Fachkonferenz	FEMALE
Fachkraft	FEMALE
Fachkreis	FEMALE
Fachkräftemangel	FEMALE
Fachkunde	FEMALE
Fachlehrer	FEMALE
Fachleute	FEMALE
Fachliteratur	FEMALE
Fachmagazin	FEMALE
Fachmann	FEMALE
Fachmarkt	FEMALE
Fachmesse	FEMALE
Fachminister	FEMALE
Fahrzeit	FEMALE
Fahrzeug	FEMALE
Fahrzeug-	FEMALE
Fahrzeugbau	FEMALE
Fahrzeugentwicklung	FEMALE
Fahrzeugführer	FEMALE
Fahrzeugkatalysator	FEMALE
Fahrzeugmängel	FEMALE
Fahrzeugschein	FEMALE
Fahrzeugstudie	FEMALE
Faible	FEMALE
Fall	MALE
Familiename	FEMALE
Familienarbeit	FEMALE
Familienaufenthalt	FEMALE
Familienausflug	FEMALE
Familienbeihilfe	FEMALE
Familienberatung	FEMALE
Familienbesitz	FEMALE
Familienbesuch	FEMALE
Familienbetrieb	FEMALE
Familienbetriebe	FEMALE
Familienbildung	FEMALE
Familienbuch	FEMALE
Familiendrama	FEMALE
Familieneinkommen	FEMALE
Familienfeier	FEMALE
Familienfest	FEMALE
Familienfirma	FEMALE
Familienfoto	FEMALE
Familienfreund	FEMALE
Familienfreundlichkeit	FEMALE
Familiengericht	FEMALE
Familiengeschichte	FEMALE
Familiengesellschafter	FEMALE
Familienhilfe	FEMALE
Familienhotel	FEMALE
Familienkonzern	FEMALE
Familienkorrespondenz	FEMALE
Familienkreis	FEMALE
Familienleben	FEMALE
Familienministerin	FEMALE
Familienministerium	FEMALE
Familienmitglied	FEMALE
Familienplanung	FEMALE
Familienpolitik	FEMALE
Familienprogramm	FEMALE
Familienrecht	FEMALE
Familiensommer	FEMALE
Familienstand	FEMALE
Familientag	FEMALE
Familientarif	FEMALE
Familientreffen	FEMALE
Familienumfeld	FEMALE
Familienumkleidekabine	FEMALE
Familienunterbringung	FEMALE
Familienunternehmen	FEMALE
Familienurlaub	FEMALE
Familienurlaubsreise	FEMALE
Familienvater	FEMALE
Familienwohnheim	FEMALE
Familienzimmer	FEMALE
Familienzusammenführung	FEMALE
Farbe	FEMALE
Farbenwerte	FEMALE
Farbfotodruck	FEMALE
Farbfotodrucker	FEMALE
Farbgebung	FEMALE
Farbigkeit	FEMALE
Farbkörper	FEMALE
Farbnuance	FEMALE
Farborgie	FEMALE
Farbphotodruck	FEMALE
Farbphotodrucker	FEMALE
Farbpigment	FEMALE
Farbscankopf	FEMALE
Farbschattierung	FEMALE
Farbseite	FEMALE
Farbspaß	FEMALE
Farbstift	FEMALE
Farbstiftzeichnung	FEMALE
Farbstoff	FEMALE
Farbsättigung	FEMALE
Farbtank	FEMALE
Farbtiefe	FEMALE
Farbtintenpatrone	FEMALE
Farbton	FEMALE
Farbverlauf	FEMALE
Farbvorrat	FEMALE
Farbwerk	FEMALE
Farbwiedergabe	FEMALE
Fastenzeit	FEMALE
Fastnacht-	FEMALE
Fastnachtsmoderation	FEMALE
Fastnachtssamstag-	FEMALE
Faszination	FEMALE
Faszinierend	FEMALE
Feierabend	MALE
Feierabend-	MALE
Feierabendwinzer	MALE
Feierlichkeit	MALE
Feierstunde	MALE
Feiertag	MALE
Feiertagsverkehr	MALE
Feigheit	MALE
Feind	MALE
Feindbild	MALE
Feindschaft	MALE
Feindseligkeit	MALE
Feindvermögen	MALE
Feinheit	MALE
Feinkostgeschäft	MALE
Feinschliff	MALE
Feinschmecker	MALE
Feinschmeckerleben	MALE
Feinstaub	MALE
Felchen	MALE
Feld	MALE
Feldarbeit	MALE
Feldbahn	MALE
Feldberg-	MALE
Fels	MALE
Felsberg	MALE
Felsbrocken	MALE
Felsenschauanlage	MALE
Felsmalerei	MALE
Felsplatte	MALE
Felswand	MALE
Fenchel	MALE
Fenster	MALE
Fensterfront	MALE
Fensterln	MALE
Fensterläde	MALE
Fensterplatz	MALE
Fensterscheibe	MALE
Ferien	MALE
Ferienangebot	MALE
Ferienanlage	MALE
Ferienareal	MALE
Ferienauto	MALE
Ferienbekanntschaft	MALE
Ferienbetreuer	MALE
Feriencamp	MALE
Ferienclub	MALE
Feriendorf	MALE
Ferienfirma	MALE
Feriengebiet	MALE
Ferienhaus	MALE
Ferienhausvermietung	MALE
Ferienherberge	MALE
Ferienhotel	MALE
Ferienhütte	MALE
Ferienjob	MALE
Ferienkomplex	MALE
Ferienlager	MALE
Ferienmonat	MALE
Ferienort	MALE
Ferienparadies	MALE
Ferienpark	MALE
Ferienranch	MALE
Ferienregion	MALE
Feriensiedlung	MALE
Ferienspass	MALE
Ferienspiel	MALE
Ferienstimmung	MALE
Ferientag	MALE
Ferienwohnung	MALE
Ferienzeit	MALE
Ferienzentrum	MALE
Ferienziel	MALE
Ferienzone	MALE
Ferienzugkonzept	MALE
Ferkel	MALE
Festlegung	FEMALE
Festlichkeit	FEMALE
Festnahme	FEMALE
Festnetz-	FEMALE
Festnetzanschluss	FEMALE
Festnetzprodukt	FEMALE
Festplatte	FEMALE
Festplattenkapazität	FEMALE
Festplattenlaufwerk	FEMALE
Festplatz	FEMALE
Festprogramm	FEMALE
Festreden	FEMALE
Festschreibung	FEMALE
Festsetzung	FEMALE
Festsetzungsfrist	FEMALE
Festspiel	FEMALE
Festspielhaus	FEMALE
Festspielkuratoriumssitzung	FEMALE
Feststellung	FEMALE
Feststellung	FEMALE
Feststellungsantrag	FEMALE
Feststellungsbescheid	FEMALE
Feststellungsklage	FEMALE
Feststellungsverfahren	FEMALE
Festtag	FEMALE
Festung	FEMALE
Festungsanlage	FEMALE
Festungsschloss	FEMALE
Festzelt	FEMALE
Festzuschuß	FEMALE
Fete	FEMALE
Fetisch	FEMALE
Fettabsaugen	FEMALE
Fettgewebe	FEMALE
Fettleibigkeit	FEMALE
Fettsäure	FEMALE
Fetzen	FEMALE
Feuchtgebiet	FEMALE
Feuchtigkeit	FEMALE
Feuchtmarker	FEMALE
Feudalismus	FEMALE
Feuer	FEMALE
Feuereifer	FEMALE
Feuergarbe	FEMALE
Feuerlöscher	FEMALE
Feuerpause	FEMALE
Feuerreiterzimmer	FEMALE
Feuerschaden	FEMALE
Feuerstellung	FEMALE
Feuerversicherung	FEMALE
Feuerwache	FEMALE
Feuerwasser	FEMALE
Feuerwehr	FEMALE
Feuerwehr-	FEMALE
Feuerwehrauto	FEMALE
Feuerwehrfrau	FEMALE
Feuerwehrleute	FEMALE
Feuerwehrmann	FEMALE
Feuerwehrsprecher	FEMALE
Feuerwehrwagen	FEMALE
Feuerwerk	FEMALE
Feuerwerkskörper	FEMALE
Feuerzeug	FEMALE
Filmmusik	FEMALE
Filmographie	FEMALE
Filmpreis	FEMALE
Filmproduktion	FEMALE
Filmprogramm	FEMALE
Filmprojekt	FEMALE
Filmrecht	FEMALE
Filmschauspielerin	FEMALE
Filmstar	FEMALE
Filmstiftung	FEMALE
Filmsystem	FEMALE
Filmtag	FEMALE
Filmtheater	FEMALE
Filmtipp	FEMALE
Filmtitel	FEMALE
Filmvertrag	FEMALE
Filmvorführung	FEMALE
Filmwirtschaft	FEMALE
Filofax	FEMALE
Filter	FEMALE
Filz	FEMALE
Filzomanie	FEMALE
Finale	FEMALE
Finalrunde	FEMALE
Finaltag	FEMALE
Finalteilnehmer	FEMALE
Fisch	MALE
Fischart	MALE
Fischen	MALE
Fischer-	MALE
Fischerdorf	MALE
Fischerei	MALE
Fischereiabkommen	MALE
Fischereiministerium	MALE
Fischereipolitik	MALE
Fischfang	MALE
Fischfangen	MALE
Fischfangrecht	MALE
Fischknochen	MALE
Fischladen	MALE
Flaschenwein	MALE
Flash	MALE
Flatron	MALE
Flaute	MALE
Fleck	MALE
Fleckchen	MALE
Flecken	MALE
Flitterwochen-	MALE
Flitterwochen-	MALE
Flitzer	MALE
Flocke	MALE
Floh	MALE
Flohhandel	MALE
Flohmarkt	MALE
Flop	MALE
Flora	MALE
Flug	FEMALE
Flug-	FEMALE
Flugabwehrstellung	FEMALE
Flugangebot	FEMALE
Flugangst	FEMALE
Flugauskunft	FEMALE
Flugbegleiter	FEMALE
Flugbestellung	FEMALE
Flugbetrieb	FEMALE
Flugbewegung	FEMALE
Flugblatt	FEMALE
Flugbuchung	FEMALE
Flugdatum	FEMALE
Flugdauer	FEMALE
Fluggast	FEMALE
Fluggesellschaft	FEMALE
Flughafen	FEMALE
Flughafen-	FEMALE
Flughafen-	FEMALE
Flughafenbus	FEMALE
Flughafenhotel	FEMALE
Flughafeninsel	FEMALE
Flughafenlinie	FEMALE
Flughafenparkhaus	FEMALE
Flughafenpolitik	FEMALE
Flughafenregelung	FEMALE
Flughafensystem	FEMALE
Flughafenverfahren	FEMALE
Flughinweis	FEMALE
Flugkapitän	FEMALE
Flugkarte	FEMALE
Flugleitzentrum	FEMALE
Fluglinie	FEMALE
Fluglotse	FEMALE
Fluglärm	FEMALE
Flugminute	FEMALE
Flugmöglichkeit	FEMALE
Flugnummer	FEMALE
Flugoperation	FEMALE
Flugpartner	FEMALE
Flugpauschalangebot	FEMALE
Flugpauschalreise	FEMALE
Flugplan	FEMALE
Flugplatz	FEMALE
Flugpreis	FEMALE
Flugrallye	FEMALE
Flugreise	FEMALE
Flugreservierung	FEMALE
Flugrettungsdienst	FEMALE
Flugschein	FEMALE
Flugsicherung	FEMALE
Flugsitz	FEMALE
Flugsportvereinigung	FEMALE
Flugstunde	FEMALE
Flugtag	FEMALE
Flugtermin	FEMALE
Flugticket	FEMALE
Flugtransfer	FEMALE
Flugunterlage	FEMALE
Flugverbindung	FEMALE
Flugverkehr	FEMALE
Flugzeit	FEMALE
Flugzeug	FEMALE
Flugzeug-	FEMALE
Flörsheimer	MALE
Flöte	MALE
Flüssigkeit	FEMALE
Fohlsäure	FEMALE
Folge	FEMALE
Folgeerkrankung	FEMALE
Folgejahr	FEMALE
Folgekosten	FEMALE
Folgenabschätzung	FEMALE
Folgerung	FEMALE
Folgeschaden	FEMALE
Folgetermin	FEMALE
Folgewoche	FEMALE
Folgezeit	FEMALE
Folie	FEMALE
Folk-	FEMALE
Forderung	FEMALE
Forderungskatalog	FEMALE
Forderungsverzicht	FEMALE
Forschungslandschaft	FEMALE
Forschungsmillion	FEMALE
Forschungsminister	FEMALE
Forschungsministerin	FEMALE
Forschungsministerium	FEMALE
Forschungspolitik	FEMALE
Forschungsprogramm	FEMALE
Forschungsprojekt	FEMALE
Forschungsressort	FEMALE
Forschungssatellit	FEMALE
Forschungsschwerpunkt	FEMALE
Forschungsstand	FEMALE
Forschungsstelle	FEMALE
Forschungsteam	FEMALE
Forschungsverbund	FEMALE
Forschungsvorhaben	FEMALE
Forschungszentrum	FEMALE
Forschungsziel	FEMALE
Forschungszweck	FEMALE
Forstamt	FEMALE
Forstarbeiter	FEMALE
Forstbehörde	FEMALE
Forsteinrichtungswerk	FEMALE
Forsthaus	FEMALE
Forsthausmitarbeiter	FEMALE
Forstpension	FEMALE
Forstverwaltungsgebäude	FEMALE
Forstwirtschaft	FEMALE
Forsythe-	FEMALE
Fortbewegungsmittel	FEMALE
Fortbildung	FEMALE
Fortbildungsmaßnahme	FEMALE
Fortbildungsreihe	FEMALE
Fortbildungsveranstaltung	FEMALE
Fortdauer	FEMALE
Fortentwicklung	FEMALE
Fortführung	FEMALE
Fortissimo-	FEMALE
Fortpflanzung	FEMALE
Fortpflanzungsorgan	FEMALE
Fortschreibung	FEMALE
Fortschritt	FEMALE
Fortsetzung	FEMALE
Fortzahlung	FEMALE
Fortüne	FEMALE
Forum	FEMALE
Fossil	FEMALE
Foto	FEMALE
Foto-	FEMALE
Foto-	FEMALE
Fotoabzug	FEMALE
Fotoanwendung	FEMALE
Fotoapparat	FEMALE
Fotoausdruck	FEMALE
Fotoausstellung	FEMALE
Fotodruck	FEMALE
Fotodrucker	FEMALE
Fotodruckkopf	FEMALE
Fotogalerie	FEMALE
Fotograf	FEMALE
Fotografie	FEMALE
Fotografin	FEMALE
Fotokreis	FEMALE
Fotolabor	FEMALE
Fotomotiv	FEMALE
Fotoplatte	FEMALE
Fotoqualität	FEMALE
Fotoreportage	FEMALE
Fotospezialist	FEMALE
Fotostammtisch	FEMALE
Foul	FEMALE
Franc	MALE
Frau	FEMALE
Frauchen	FEMALE
Frauen-	FEMALE
Frauen-	FEMALE
Frauen-	FEMALE
Frauen-	FEMALE
Frauen-	FEMALE
Frauenabend	FEMALE
Frauenalltag	FEMALE
Frauenanteil	FEMALE
Frauenarbeit	FEMALE
Frauenarzt	FEMALE
Frauenbeauftragt	FEMALE
Frauenbewegung	FEMALE
Frauenbild	FEMALE
Frauenchor	FEMALE
Frauenforschung	FEMALE
Frauenförderung	FEMALE
Frauengewerkschaft	FEMALE
Frauenhandel	FEMALE
Frauenhaus	FEMALE
Frauenkegelclub	FEMALE
Frauenkirche	FEMALE
Frauenministerium	FEMALE
Frauenmord	FEMALE
Frauenpolitik	FEMALE
Frauenpolitikerin	FEMALE
Frauenrecht	FEMALE
Frauenrechtsorganisation	FEMALE
Frauenreferentin	FEMALE
Frauenreise	FEMALE
Frauensendung	FEMALE
Frauenteam	FEMALE
Frauenthema	FEMALE
Fraunhofer-	FEMALE
Fraunhofer-	FEMALE
Freak	FEMALE
Freches	FEMALE
Frechheit	FEMALE
Freitag	MALE
Freitag	MALE
Freitagabend	MALE
Freitagsgebet	MALE
Freitagstermin	MALE
Freiwilligkeit	MALE
Freizeit	FEMALE
Freizeitaktivität	FEMALE
Freizeitangebot	FEMALE
Freizeiteinrichtung	FEMALE
Freizeitforscher	FEMALE
Freizeitgeschehen	FEMALE
Freizeitgesellschaft	FEMALE
Freizeitgestaltung	FEMALE
Freizeitkapitän	FEMALE
Freizeitmöglichkeit	FEMALE
Freizeitpark	FEMALE
Freizeitraum	FEMALE
Freizeitunternehmen	FEMALE
Freizeitzentrum	FEMALE
Freizügigkeit	FEMALE
Fremdsprachenunterricht	MALE
Fremdwort	MALE
Fremdwährung	MALE
Friedensarbeit	FEMALE
Friedensbemühung	FEMALE
Friedensbewegung	FEMALE
Friedensdemonstration	FEMALE
Friedensdividende	FEMALE
Friedensdrama	FEMALE
Friedenseinsatz	FEMALE
Friedensengagement	FEMALE
Friedenserziehung	FEMALE
Friedensforschung	FEMALE
Friedensgespräch	FEMALE
Friedensinitiative	FEMALE
Friedensinstrument	FEMALE
Friedenskarawane	FEMALE
Friedenskonferenz	FEMALE
Friedenskundgebung	FEMALE
Friedenslager	FEMALE
Friedenslösung	FEMALE
Friedensmission	FEMALE
Friedensnobelpreis	FEMALE
Friedensnobelpreisträger	FEMALE
Friedensnobelpreisträgerin	FEMALE
Friedensorganisation	FEMALE
Friedenspartner	FEMALE
Friedensplan	FEMALE
Friedenspolitik	FEMALE
Friedenspreis	FEMALE
Friedensprozess	FEMALE
Friedensprozeß	FEMALE
Friedensratschlag	FEMALE
Friedensritter	FEMALE
Friedensschluß	FEMALE
Friedenssicherung	FEMALE
Friedensstrasse	FEMALE
Friedensstreitmacht	FEMALE
Friedenstruppe	FEMALE
Friedensverhandlung	FEMALE
Friedensvermittler	FEMALE
Friedensvertrag	FEMALE
Friedenswahrung	FEMALE
Friedenszeit	FEMALE
Friedfertigkeit	FEMALE
Frischluft	FEMALE
Friseur	FEMALE
Friseurladen	FEMALE
Friseursalon	FEMALE
Friseurstuhl	FEMALE
Frist	FEMALE
Fristablauf	FEMALE
Fristsetzung	FEMALE
Fristverkürzung	FEMALE
Frisur	FEMALE
Fruchtsaft	MALE
Früh	MALE
Frühaufsteher	MALE
Frühaufsteherin	MALE
Frühbucher	MALE
Frühbucher-	MALE
Frühbuchervorteil	MALE
Früherkennung	MALE
Früherziehung	MALE
Frühförderung	MALE
Frühjahr	MALE
Frühjahrssturm	MALE
Frühling	MALE
Frühlingsanfang	MALE
Frühlingsferien	MALE
Frühlingssegeln	MALE
Frühlingswetter	MALE
Frühpensionierung	MALE
Frühprogramm	MALE
Frühsommer	MALE
Frühzeit	FEMALE
Fünf-	MALE
Fünf-	MALE
Galle	FEMALE
Garantie	FEMALE
Garantieleistung	FEMALE
Garantiepaket	FEMALE
Garantiezeit	FEMALE
Gebratenes	MALE
Gebrauch	MALE
Gebrauchsanweisung	FEMALE
Gebrauchsgegenstand	FEMALE
Gebrauchswert	FEMALE
Gebrauchtwagen	FEMALE
Gebrechen	FEMALE
Gebrüder	FEMALE
Geburt	FEMALE
Geburtenrate	FEMALE
Geburtshaus	FEMALE
Geburtshelfer	FEMALE
Geburtshelferin	FEMALE
Geburtshilfe	FEMALE
Geburtsort	FEMALE
Geburtsstadt	FEMALE
Geburtsstunde	FEMALE
Geburtstag	FEMALE
Geburtstagsempfang	FEMALE
Geburtstagsfeier	FEMALE
Geburtstagsservice	FEMALE
Geburtstdatum	FEMALE
Geburtsurkunde	FEMALE
Gebühr	FEMALE
Gebührenbefreiung	FEMALE
Gebührendifferenz	FEMALE
Gebührenerhöhung	FEMALE
Gebührenmodell	FEMALE
Gebührenordnung	FEMALE
Gebührenzahler	FEMALE
Gebührenzahlerin	FEMALE
Gebührenzähler	FEMALE
Gebüsch	FEMALE
Gedanke	FEMALE
Gedanke	MALE
Gedankenaustausch	MALE
Gedankengang	MALE
Gedankengut	MALE
Gedankenlosigkeit	MALE
Gedankenspiel	MALE
Gedankenwelt	MALE
Gedenkfeier	MALE
Gedenkminute	MALE
Gedenkstein	MALE
Gedenkstätte	MALE
Gedenktafel	MALE
Gedenkveranstaltung	MALE
Gedächtnis	FEMALE
Gefahr	FEMALE
Geiselnahme	FEMALE
Geiselnehmer	FEMALE
Geist	FEMALE
Geisterbild	FEMALE
Geisterhaus	FEMALE
Geisterspektakel	FEMALE
Geisterstunde	FEMALE
Geistesbildung	FEMALE
Geistesblitz	FEMALE
Geistesentfaltung	FEMALE
Geistesgeschichte	FEMALE
Geisteshaltung	FEMALE
Geisteswissenschaft	FEMALE
Geisteszustand	FEMALE
Geistlich	FEMALE
Geistlichkeit	FEMALE
Geistmitteilung	FEMALE
Geistversenkung	FEMALE
Geißelbündel	FEMALE
Geißelmotor	FEMALE
Geißelpropeller	FEMALE
Gelatine	FEMALE
Gelegenheit	FEMALE
Gelehrsamkeit	FEMALE
Gelehrt	FEMALE
Gelehrtenversammlung	FEMALE
Geleitschutz	FEMALE
Gelenk	FEMALE
Gelenkveränderung	FEMALE
Gemeinwesenarbeit	FEMALE
Gemäldegalerie	FEMALE
Gemüsebrühe	FEMALE
Gemüseexporteur	FEMALE
Gemüsegarten	FEMALE
Gemüseladen	FEMALE
Gemüsemarktordnung	FEMALE
Gemüsestand	FEMALE
Gemüt	FEMALE
Gemütlichkeit	FEMALE
Gemütsverfassung	FEMALE
Gemütswallung	FEMALE
Gemütszustand	FEMALE
Gen	FEMALE
Genauigkeit	FEMALE
Gerste	FEMALE
Gerstensaft	MALE
Geschehnis	FEMALE
Geschenk	FEMALE
Geschichte	FEMALE
Geschichtenerzählen	FEMALE
Geschichtsbild	FEMALE
Geschichtsbuch	FEMALE
Geschichtsentsorger	FEMALE
Geschichtsklitterung	FEMALE
Geschichtsschreiber	FEMALE
Geschichtsschreibung	FEMALE
Geschichtsunterricht	MALE
Geschichtsverein	MALE
Geschichtswissenschaft	MALE
Geschick	MALE
Geschicklichkeit	MALE
Geschicklichkeits-	MALE
Geschicklichkeitsspiel	MALE
Geschirr	MALE
Geschirrmobil	MALE
Geschirrspülmaschine	MALE
Geschirrteil	MALE
Geschlecht	MALE
Geschlechterforschung	MALE
Geschlechterkonflikt	MALE
Geschlechterrolle	MALE
Geschlechterverhältnis	MALE
Geschlechtlichkeit	MALE
Geschlechtskrankheit	MALE
Geschlechtsverkehr	MALE
Geschlossenheit	MALE
Geschmack	MALE
Geschmacklosigkeit	MALE
Geschmackssache	MALE
Geschoss	MALE
Geschosswohnungsbauten	MALE
Geschwader	MALE
Geschwindigkeit	MALE
Geschwister	MALE
Geschworen	MALE
Geschworenengericht	MALE
Geschwätz	MALE
Geschwür	MALE
Geschäftemachen	MALE
Geschäftemacher	MALE
Geschäftsanbahnung	MALE
Geschäftsanteil	MALE
Geschäftsbeziehung	MALE
Geschäftseingang	MALE
Geschäftserfolg	MALE
Geschäftsergebnis	MALE
Geschäftsführungssprecher	MALE
Geschäftsgrundlage	MALE
Geschäftshaus	MALE
Geschäftsidee	FEMALE
Geschäftsinteresse	FEMALE
Geschäftsinvestor	MALE
Geschäftsjahr	FEMALE
Geschäftskonferenz	FEMALE
Geschäftskontakt	MALE
Geschäftskosten	FEMALE
Geschäftskunde	FEMALE
Geschäftslage	MALE
Geschäftsleben	FEMALE
Geschäftsleiter	FEMALE
Geschäftsleitung	FEMALE
Geschäftsleute	FEMALE
Geschäftsmann	FEMALE
Geschäftsmann	MALE
Geschäftsmodell	FEMALE
Geschäftsnummer	FEMALE
Geschäftsordnung	FEMALE
Geschäftspartner	FEMALE
Geschäftspartnerin	FEMALE
Geschäftspolitik	FEMALE
Geschäftsprozess	FEMALE
Geschäftsraum	FEMALE
Geschäftsreise	FEMALE
Geschäftsreisende	FEMALE
Geschäftsschluß	MALE
Geschäftsschlußzeit	MALE
Geschäftsschädigung	MALE
Geschäftssparte	FEMALE
Geschäftsstelle	FEMALE
Geschäftstag	FEMALE
Geschäftstermin	FEMALE
Geschäftstreffen	FEMALE
Geschäftsträger	MALE
Geschäftstätigkeit	MALE
Geschäftsverhandlung	FEMALE
Geschäftsverkehr	FEMALE
Geschäftsverlauf	FEMALE
Geschäftsviertel	FEMALE
Geschäftsvolumen	MALE
Geschäftswagen	FEMALE
Geschäftswert	FEMALE
Geschäftszeit	MALE
Geschäftszentrum	FEMALE
Geschäftsöffnungszeit	MALE
Geschöpf	MALE
Geschütz	MALE
Geselligkeit	MALE
Gesellschaft	MALE
Gesellschafter	MALE
Gesellschafterdarlehen	MALE
Gesellschafterin	MALE
Gesellschafterkreis	MALE
Gesellschafterversammlung	MALE
Gesellschaftsform	MALE
Gesellschaftsgruppe	MALE
Gesellschaftskreis	MALE
Gesellschaftskritik	MALE
Gesellschaftsordnung	MALE
Gesellschaftspolitik	MALE
Gesellschaftsraum	MALE
Gesellschaftsrecht	MALE
Gesellschaftsspiel	MALE
Gesellschaftssystem	MALE
Gesellschaftsvermögen	MALE
Gesellschaftsvertrag	MALE
Gesellschaftswissenschaft	MALE
Gesetz	MALE
Gesetzblatt	MALE
Gesetzbuch	MALE
Gesetzentwurf	MALE
Gesetzesbegründung	MALE
Gesetzesentwurf	MALE
Gesetzesinitiative	MALE
Gesetzeslage	MALE
Gesetzesplan	MALE
Gesetzesteil	MALE
Gesetzestext	MALE
Gesetzesvorhaben	MALE
Gesetzeswortlaut	MALE
Gesetzesänderung	MALE
Gesetzgeber	MALE
Gesetzgebung	MALE
Gesetzgebungskompetenz	MALE
Gesetzgebungsprozedur	MALE
Gesetzgebungsverfahren	MALE
Gesetzmäßigkeit	MALE
Gesicht	MALE
Gesichtsausdruck	MALE
Gesichtsbehandlung	MALE
Gesichtsfeld	MALE
Gesichtspunkt	MALE
Gesichtszug	MALE
Gesinnung	MALE
Gespann	MALE
Gespenst	MALE
Gespensterschloss	MALE
Gespräch	MALE
Gesprächsangebot	MALE
Gesprächsbedarf	MALE
Gesprächsbereitschaft	MALE
Gesprächsführung	MALE
Gesprächsgebühr	MALE
Gesprächskreis	MALE
Gesprächsleitung	MALE
Gesprächspartner	MALE
Gesprächsrunde	MALE
Gesprächsstoff	MALE
Gesprächstermin	MALE
Gespür	MALE
Gestik	FEMALE
Gestirn	FEMALE
Gestoden	FEMALE
Gesträuch	FEMALE
Gestrüpp	FEMALE
Gestus	FEMALE
Geständnis	FEMALE
Gestüt	FEMALE
Gesundheit	FEMALE
Gesundheitsamt	FEMALE
Gesundheitsausgabe	FEMALE
Gesundheitsbehörde	FEMALE
Gesundheitsbereich	FEMALE
Gesundheitsberuf	FEMALE
Gesundheitscenter	FEMALE
Gesundheitsdienst	FEMALE
Gesundheitserziehung	FEMALE
Gesundheitsexperte	FEMALE
Gesundheitsferien	FEMALE
Gesundheitsförderung	FEMALE
Gesundheitsfürsorge	FEMALE
Gesundheitsgefahr	FEMALE
Gesundheitsgefährdung	FEMALE
Gesundheitsgrund	FEMALE
Gesundheitskarte	FEMALE
Gesundheitsmarkt	FEMALE
Gesundheitsminister	FEMALE
Gesundheitsministerin	FEMALE
Gesundheitsministerium	FEMALE
Gesundheitspolitik	FEMALE
Gesundheitsproblem	FEMALE
Gesundheitsprogramm	FEMALE
Gesundheitsreform	FEMALE
Gesundheitsrisiko	FEMALE
Gesundheitsschaden	FEMALE
Gesundheitsschutz	FEMALE
Gesundheitssektor	FEMALE
Gesundheitssystem	FEMALE
Gesundheitsversorgung	FEMALE
Gesundheitsverwaltung	FEMALE
Gesundheitsvorsorge	FEMALE
Gesundheitswesen	FEMALE
Gesundheitszentrum	FEMALE
Gesundheitszustand	FEMALE
Gesundung	FEMALE
Gesäusel	FEMALE
Gewahrsam	MALE
Gewalt	FEMALE
Gewaltakt	FEMALE
Gewaltanwendung	FEMALE
Gewaltbereitschaft	FEMALE
Gewalteinsatz	FEMALE
Gewaltenteilung	FEMALE
Gewaltfreiheit	FEMALE
Gewaltherrschaft	FEMALE
Gewaltlosigkeit	FEMALE
Gewaltmonopol	FEMALE
Gewaltopfer	FEMALE
Gewaltpotential	FEMALE
Gewaltprävention	FEMALE
Gewalttat	FEMALE
Gewalttätigkeit	FEMALE
Gewaltverbrechen	FEMALE
Gewand	FEMALE
Gewandhausorchester	FEMALE
Gewebe	FEMALE
Gewebe	FEMALE
Gewebeveränderung	FEMALE
Gewehr	FEMALE
Gewerbe	FEMALE
Gewerbebetrieb	FEMALE
Gewerbeertrag	FEMALE
Gewerbeertragsteuer	FEMALE
Gewerbefläche	FEMALE
Gewerbegebiet	FEMALE
Gewerbekapitalsteuer	FEMALE
Gewerbeordnung	FEMALE
Gewerbesteuer	FEMALE
Gewerbesteuereinnahme	FEMALE
Gewerbesteuerentlastung	FEMALE
Gewerbesteuermodell	FEMALE
Gewerbesteuersenkung	FEMALE
Gewerbetreibend	FEMALE
Gewerkschaft	FEMALE
Gewerkschafter	FEMALE
Gewerkschafterin	FEMALE
Gewerkschaftsaktivität	FEMALE
Gewerkschaftsarbeit	FEMALE
Gewerkschaftsbewegung	FEMALE
Gewerkschaftsbund	FEMALE
Gewerkschaftsführer	FEMALE
Gewerkschaftsgutachten	FEMALE
Gewerkschaftshaus	FEMALE
Gewerkschaftsmitglied	FEMALE
Gewerkschaftspolitik	FEMALE
Gewerkschaftsregie	FEMALE
Gewerkschaftssekretär	FEMALE
Gewerkschaftssprecher	FEMALE
Gewerkschaftsstudie	FEMALE
Gewerkschaftssystem	FEMALE
Gewerkschaftstag	FEMALE
Gewerkschaftsverband	FEMALE
Gewerkschaftsvertreter	FEMALE
Gewerkschaftsvorsitzender	FEMALE
Gewerkschaftszeitung	FEMALE
Gewicht	FEMALE
Gewichtigkeit	FEMALE
Gewichtsabnahme	FEMALE
Gewichtsheber	FEMALE
Gewichtsreduktion	FEMALE
Gewichtsverlagerung	FEMALE
Gewichtsverlust	FEMALE
Gewichtszunahme	FEMALE
Gewichtung	FEMALE
Gewinn	FEMALE
Gewinnabführungsvertrag	FEMALE
Gewinnanstieg	FEMALE
Gewinnanteil	FEMALE
Gewinnausschüttung	FEMALE
Gewinnbeitrag	FEMALE
Gewinnbeteiligung	FEMALE
Gewinneinbruch	FEMALE
Gewinneinbuße	FEMALE
Gewinner	FEMALE
Gewinnermittlung	FEMALE
Gewinnerzielungsabsicht	FEMALE
Gewinnexplosion	FEMALE
Gewinnposition	FEMALE
Gewinnrückgang	FEMALE
Gewinnrücklage	FEMALE
Gewinnschätzung	FEMALE
Gewinnspanne	FEMALE
Gewinnspiel	FEMALE
Gewinnung	FEMALE
Gewinnzone	FEMALE
Gewirr	FEMALE
Gewissen	FEMALE
Gewissenlosigkeit	FEMALE
Gewissensentscheidung	FEMALE
Gewissensfreiheit	FEMALE
Gewissensgrund	FEMALE
Gewissheit	FEMALE
Gewitterguss	FEMALE
Gewitterwolke	FEMALE
Gewohnheit	FEMALE
Geworschtel	FEMALE
Gewächs	FEMALE
Gewährträgerhaftung	FEMALE
Gewöhnung	FEMALE
Gewölbe	FEMALE
Gewürz	FEMALE
Gezerre	FEMALE
Gezeter	FEMALE
Gips	MALE
Gipsfassade	MALE
Gipsfenster	MALE
Giraffe	MALE
Giro-	MALE
Giro-	MALE
Giro-	MALE
Girokonto	MALE
Glut	FEMALE
Gläubigerbank	FEMALE
Gläubigerstaat	FEMALE
Glöckchen	FEMALE
Glücksritter	FEMALE
Glücksritterin	FEMALE
Glühwein	MALE
GmbH	FEMALE
Gnade	FEMALE
Gnadenfrist	FEMALE
Gnadengesuch	FEMALE
Golfurlaub	MALE
Grippe	FEMALE
Grobeinstellung	FEMALE
Grossbank	FEMALE
Grossbrand	FEMALE
Grossbäckerei	FEMALE
Großansicht	FEMALE
Großbank	FEMALE
Großbildleinwand	FEMALE
Großbildschirm	FEMALE
Grummeln	MALE
Grund	MALE
Grund	MALE
Grundannahme	MALE
Grundauffassung	MALE
Grundausbildung	MALE
Grundausstattung	MALE
Grundbedingung	MALE
Grundbedürfnis	MALE
Grundbegriff	MALE
Grundbesitz	MALE
Grundbesitzer	MALE
Grundbildung	MALE
Grundbuch	MALE
Grundcharakter	MALE
Grundchemikalie	MALE
Grundeigentum	MALE
Grundeigentümer	MALE
Grundeinkommen	MALE
Grundeinstellung	MALE
Grunderwerbssteuer	MALE
Grundfeste	MALE
Grundfläche	MALE
Grundform	MALE
Grundfrage	MALE
Grundfreibetrag	MALE
Grundfreiheit	MALE
Grundgebühr	MALE
Grundgedanke	MALE
Grundgedanken	MALE
Grundgehalt	MALE
Grundgesetz	MALE
Grundgesetzartikel	MALE
Grundgesetzwidrigkeit	MALE
Grundgesetzänderung	MALE
Grundhaltung	MALE
Grundidee	FEMALE
Grundierung	FEMALE
Grundkapital	FEMALE
Grundkapitel	FEMALE
Grundkenntniss	FEMALE
Grundkonsens	FEMALE
Grundkreditbank	FEMALE
Grundkurs	FEMALE
Grundlage	FEMALE
Grundlagenforschung	FEMALE
Grundlagenvertrag	FEMALE
Grundlegung	FEMALE
Grundlinie	FEMALE
Grundlinienspiel	FEMALE
Grundmauer	FEMALE
Grundmuster	FEMALE
Grundnahrungsmittel	FEMALE
Grundnetz	FEMALE
Grundnetzstraße	FEMALE
Grundordnung	FEMALE
Grundorganisation	FEMALE
Grundpfeiler	FEMALE
Grundposition	FEMALE
Grundprinzip	FEMALE
Grundvoraussetzung	FEMALE
Gruppenarbeit	FEMALE
Gruppenbildung	FEMALE
Gruppengefühl	FEMALE
Gruppengewinn	FEMALE
Gruppenleistung	FEMALE
Gruppenleiter	FEMALE
Gruppenleiterin	FEMALE
Gruppenleitung	FEMALE
Gruppenloyalität	FEMALE
Gruppenmitglied	FEMALE
Gruppenname	FEMALE
Gruppenraum	FEMALE
Gruppenreise	FEMALE
Gruppenreisende	FEMALE
Gruppensieg	FEMALE
Gruppenspiel	FEMALE
Gruppentarif	FEMALE
Gruppentreffen	FEMALE
Gruppenumsatz	FEMALE
Gruppenunterricht	MALE
Gruppenverfolgung	MALE
Gruppenzweite	MALE
Gruppierung	MALE
Gruseltat	MALE
Gruß	MALE
Grußwort	MALE
Grün	MALE
Gründerzeit	FEMALE
Gründlichkeit	FEMALE
Gründonnerstag	MALE
Gründung	MALE
Gründungsakte	MALE
Gründungsmitglied	MALE
Grüne-	MALE
Grünen-	MALE
Grünen-	MALE
Grünen-	MALE
GrünenFraktion	MALE
Grünfläche	MALE
Grünfläche	MALE
Grüngürtel-	MALE
Grünland	MALE
Guerilla	FEMALE
Guerilla-	FEMALE
Guerillabewegung	FEMALE
Guerillagruppe	FEMALE
Guerillaorganisation	FEMALE
Guerillero	FEMALE
Gülle	FEMALE
Gültigkeit	FEMALE
Haarfarbe	FEMALE
Hafer	MALE
Hagen	MALE
Hausarbeit	FEMALE
Hausarrest	FEMALE
Hausarzt	FEMALE
Hausaufgabe	FEMALE
Hausaufgabenhilfe	FEMALE
Hausbank	FEMALE
Hausbau	FEMALE
Hausbesitzer	FEMALE
Hausbewohner	FEMALE
Hausboot	FEMALE
Hausdurchsuchung	FEMALE
Hauseigentümer	FEMALE
Hauseigner	FEMALE
Hausfarbe	FEMALE
Hausfrau	FEMALE
Hausfrauenarbeit	FEMALE
Hausgast	FEMALE
Hausgebrauch	FEMALE
Hausgerät	FEMALE
Haushalt	FEMALE
Haushaltbedarf	FEMALE
Haushaltsausschuss	FEMALE
Haushaltsbedarf	FEMALE
Haushaltsberatung	FEMALE
Haushaltsdefizit	FEMALE
Haushaltsentwurf	FEMALE
Haushaltsexperte	FEMALE
Haushaltsführung	FEMALE
Haushaltsgerät	FEMALE
Haushaltsgerätehersteller	FEMALE
Haushaltsgesetz	FEMALE
Haushaltsgrundsätzegesetz	FEMALE
Haushaltshilfe	FEMALE
Haushaltsklarheit	FEMALE
Haushaltskommissar	FEMALE
Haushaltskonflikt	FEMALE
Haushaltskonsolidierung	FEMALE
Haushaltslage	FEMALE
Haushaltsleiter	FEMALE
Haushaltsmarkt	FEMALE
Haushaltsmehrheit	FEMALE
Haushaltsminister	FEMALE
Haushaltsmittel	FEMALE
Haushaltsplan	FEMALE
Haushaltspolitik	FEMALE
Haushaltsrecht	FEMALE
Haushaltsreferent	FEMALE
Haushaltsreform	FEMALE
Haushaltssanierung	FEMALE
Haushaltsschuld	FEMALE
Haushaltssicherungsgesetz	FEMALE
Haushaltssperre	FEMALE
Haushaltssprecher	FEMALE
Haushaltsverhandlung	FEMALE
Haushaltsübergangsgesetz	FEMALE
Hausherr	FEMALE
Haushälterin	FEMALE
Hausinspektor	FEMALE
Hausmeister	FEMALE
Hausmusik	FEMALE
Hausnummer	FEMALE
Hausordnung	FEMALE
Hausrat	MALE
Haussa	MALE
Haussammlung	MALE
Hausseminar	MALE
Hauswein	MALE
Hauswirtschaft	MALE
Haut	MALE
Hautarzt	MALE
Hautfarbe	FEMALE
Hautinfektion	FEMALE
Hautkrankheit	FEMALE
Hautkrebs	FEMALE
Hautprobe	FEMALE
Hautproblem	FEMALE
Hautrötung	FEMALE
Hautton	FEMALE
Heimarbeit	FEMALE
Heimat	FEMALE
Heimatchronik	FEMALE
Heimatdichter	FEMALE
Heimatforscher	FEMALE
Heimatgebiet	FEMALE
Heimathafen	FEMALE
Heimatkloster	FEMALE
Heimatland	FEMALE
Heimatmarkt	FEMALE
Heimatmuseum	FEMALE
Heimatort	FEMALE
Heimatregion	FEMALE
Heimatstadt	FEMALE
Heimatverband	FEMALE
Heimbereich	FEMALE
Heimcomputermarkt	FEMALE
Heimelektronik	FEMALE
Heimfahrt	FEMALE
Herbst	MALE
Herbstferien	MALE
Herbstgutachten	MALE
Herbstwetter	MALE
Herr	MALE
Herrchen	MALE
Hochschullandschaft	FEMALE
Hochschullehrer	FEMALE
Hochschulpolitik	FEMALE
Hochschulrahmengesetz	FEMALE
Hochschulreife	FEMALE
Hochschulrektor	FEMALE
Hoffnung	FEMALE
Hoffnungslosigkeit	FEMALE
Hoffnungsschimmer	FEMALE
Hoffnungsträger	FEMALE
Hofheimer	FEMALE
Hofleute	FEMALE
Hohlraum	MALE
Hongkong	MALE
Hopfen	MALE
Hubraum	MALE
Hubschrauber	MALE
Huf	MALE
Hummer	MALE
Hübner-	MALE
Hüfte	MALE
Hügel	MALE
Hühnchen	MALE
Hühnerei	MALE
Hühnerhaltung	MALE
Hülle	MALE
Hülsenfrucht	MALE
Hündin	MALE
Hündlein	MALE
Hütte	MALE
Hüttentechnik	MALE
Hüttenwerk	MALE
Idee	FEMALE
Idee	FEMALE
Idee	FEMALE
Ideenwettbewerb	FEMALE
Identifikation	FEMALE
Identifikationsfigur	FEMALE
Identifikationspunkt	FEMALE
Identifizierung	FEMALE
Identität	FEMALE
Identitätsbildung	FEMALE
Ideologe	FEMALE
Ideologie	FEMALE
Idiom	FEMALE
Idiot	FEMALE
Idol	FEMALE
Idylle	FEMALE
Immigration	FEMALE
Immobilie	FEMALE
Immobilienberatung	FEMALE
Immobilieneigentümer	FEMALE
Immobilienengagement	FEMALE
Immobilienfinanzierung	FEMALE
Immobilienfirma	FEMALE
Immobilienfonds	FEMALE
Immobiliengeschäft	FEMALE
Immobiliengruppe	FEMALE
Immobilienhandel	FEMALE
Immobilienimperium	FEMALE
Immobilienmarkt	FEMALE
Immobilienpreis	FEMALE
Immobilienspekulant	FEMALE
Immobilientochter	FEMALE
Immobilienunternehmen	FEMALE
Immobilienunternehmer	FEMALE
Immobilienverkauf	FEMALE
Immobilienverwaltung	FEMALE
Immobilienwirtschaft	FEMALE
Inklusive-	MALE
Inkompatibilität	MALE
Inkompetenz	MALE
Inkonsequenz	MALE
Inkrafttreten	MALE
Inkubationszeit	FEMALE
Inland	FEMALE
Inlands-	FEMALE
Inlandsflug	FEMALE
Inlandsflugtickets	FEMALE
Inlandsgeheimdienst	FEMALE
Inlandsgeschäft	FEMALE
Inlandsmarkt	FEMALE
Innenraum	MALE
Innenreinigung	MALE
Innenseite	MALE
Innensenator	MALE
Innenstadt	MALE
Innenstadt-	MALE
Innenstadtfläche	MALE
Innenstadtnähe	MALE
Innenverhältnis	MALE
Intoleranz	FEMALE
Intonation	FEMALE
Intranet	FEMALE
Intrige	FEMALE
Intro	FEMALE
Introduktion	FEMALE
Intuition	FEMALE
JCH	FEMALE
Jazzmusik	FEMALE
Jazzproduzent	FEMALE
Johannesburg	MALE
Johannesevangelium	MALE
Johanneskirche	MALE
Johanniskraut	MALE
Johanniter	MALE
Juda	MALE
Jugendkultur	FEMALE
Jugendleiter	FEMALE
Jugendlich	FEMALE
Jugendliteratur	FEMALE
Jugendmannschaft	FEMALE
Jugendorganisation	FEMALE
Jugendpolitik	FEMALE
Jugendprogramm	FEMALE
Jugendpsychiatrie	FEMALE
Jugendschutz	FEMALE
Jugendsozialarbeit	FEMALE
Jugendstil	FEMALE
Jugendstil-	FEMALE
Jugendstrafe	FEMALE
Jugendstraflager	FEMALE
Jugendstrafrecht	FEMALE
Jugendtag	FEMALE
Jugendtagebuch	FEMALE
Jugendtarif	FEMALE
Jugendteam	FEMALE
Jugendtrainer	FEMALE
Jugendtreff	FEMALE
Jugendturnier	FEMALE
Jugendverband	FEMALE
Jugendvertreter	FEMALE
Jugendwart	FEMALE
Jugendwehr	FEMALE
Jugendzeit	FEMALE
Jugendzentrum	FEMALE
Jugoslawien-	FEMALE
Julei	MALE
Juli	MALE
Juno	MALE
Jänner	MALE
KAIRO	MALE
KIEW	MALE
KULTURSPIEGEL	FEMALE
Kaffee	MALE
Kaffeehausgeschichte	MALE
Kaffeemaschine	MALE
Kaffeesatz	MALE
Kaffeetrinken	MALE
Kaffeezubereitung	MALE
Kaiser	MALE
Kaisergeschlecht	MALE
Kaiserin	MALE
Kaiserkrönung	MALE
Kaiserreich	MALE
Kaiserschnitt	MALE
Kaiserslautern	MALE
Kaiserzeit	FEMALE
Kajak-	FEMALE
Kakao	MALE
Kakerlak	MALE
Kaktuswüste	MALE
Kalzium	MALE
Kamel	MALE
Kamelle	MALE
Kameltour	MALE
Kameltreck	MALE
Kamera	MALE
Kamera-	MALE
Kamerabutton	MALE
Kamerad	MALE
Kameraderie	MALE
Kameradschaft	MALE
Kameralinse	MALE
Kameramann	MALE
Kamerateam	MALE
Kammermusik	FEMALE
Kammerorchester	FEMALE
Kammerspiel	FEMALE
Kammerton	FEMALE
Kampagne	FEMALE
Kampagnenstricker	FEMALE
Kandare	FEMALE
Kandidat	FEMALE
Kandidatenvorschlag	FEMALE
Kandidatin	FEMALE
Kandidatur	FEMALE
Kaninchen	FEMALE
Kanne	FEMALE
Kanon	FEMALE
Kanone	FEMALE
Kanonenboot	FEMALE
Kaukasus	MALE
Kausalität	MALE
Kaution	MALE
Kavallerie	MALE
Kaviar	MALE
Kellerei	FEMALE
Kellerluke	FEMALE
Kellerraum	FEMALE
Kellner	FEMALE
Kellnerin	FEMALE
Kellnertasche	FEMALE
Kelsterbacher	FEMALE
Kelten	FEMALE
Keltenspiegel	FEMALE
Kenntnisnahme	FEMALE
Kenntniss	FEMALE
Kenntnisstand	FEMALE
Kennung	FEMALE
Kennwort	FEMALE
Kennzahl	FEMALE
Kennzeichen	FEMALE
Kennzeichenänderung	FEMALE
Kennzeichnung	FEMALE
Kennzeichnungspflicht	FEMALE
Kennziffer	FEMALE
Ketchup	MALE
Kies	MALE
Kieselrot	MALE
Kiesgrube	MALE
Kiez	MALE
Kirchenmusik	FEMALE
Klassenarbeit	FEMALE
Klassenerhalt	FEMALE
Klassenfahrt	FEMALE
Klassengesellschaft	FEMALE
Klassenkamerad	FEMALE
Klassenkampf	FEMALE
Klassenkampfparole	FEMALE
Klassenlehrer	FEMALE
Klassenraum	MALE
Klassenstufe	MALE
Klassenzimmer	MALE
Klassifikation	MALE
Klassifizierung	MALE
Klassik	MALE
Klassikfan	MALE
Kleidung	FEMALE
Kleinarbeit	FEMALE
Knoblauch	MALE
Knoblauchzehe	MALE
Knochen	MALE
Knochenarbeit	MALE
Knochendichte	MALE
Knochenmark	MALE
Knöchel	MALE
Knöchel-	MALE
Kofferraum	MALE
Koffertragen	MALE
Kofferträger	MALE
Kohle	FEMALE
Kohlebergwerk	FEMALE
Kohlegrube	FEMALE
Kohlehydrierung	FEMALE
Kohlekraftwerk	FEMALE
Kohlendioxid	FEMALE
Kohlenhydrat	FEMALE
Kohlenmonoxid	FEMALE
Kohlenstaub	FEMALE
Kohlenstoff	MALE
Kohlensäure	FEMALE
Kohlenwasserstoff	MALE
Kohlepfennig	MALE
Kohlepolitik	MALE
Kohleproduzent	MALE
Kohlereserve	MALE
Kohlesubvention	MALE
Kolonialzeit	FEMALE
Kolonie	FEMALE
Kolonisation	FEMALE
Kolonist	FEMALE
Kolonne	FEMALE
Koloraturarie	FEMALE
Konsequenz	FEMALE
Konservatismus	FEMALE
Konservativ	FEMALE
Konservativ	FEMALE
Konservatorium	FEMALE
Konserve	FEMALE
Konservierung	FEMALE
Konservierungsmittel	FEMALE
Konsistenz	FEMALE
Konsistorium	FEMALE
Konsole	FEMALE
Konsolidierung	FEMALE
Konsorte	FEMALE
Konsortialführer	FEMALE
Konsortialführerin	FEMALE
Konsortialpartner	FEMALE
Konsortium	FEMALE
Konspiration	FEMALE
Konstablerwache	FEMALE
Konstruktivismus	MALE
Konsul	MALE
Konsulat	MALE
Konsulent	MALE
Konsultation	MALE
Konsultativkonferenz	MALE
Konsum	MALE
Konsum-	MALE
Konsument	MALE
Konsumentenmarkt	MALE
Konsumentenschützer	MALE
Konsumentensouveränität	MALE
Konsumgut	MALE
Konsumgüterindustrie	MALE
Konsumismus	MALE
Konsumption	MALE
Konsumtempel	MALE
Konsumtrend	MALE
Konsumverhalten	MALE
Kontakt	MALE
Kontaktadresse	MALE
Kontaktaufnahme	MALE
Kontaktlinse	MALE
Kontaktlosigkeit	MALE
Kontamination	MALE
Konteradmiral	MALE
Konterfei	MALE
Konterpart	MALE
Konterrevolution	MALE
Kontext	MALE
Kontierung	MALE
Kontinent	MALE
Kontinentalfrühstück	MALE
Kontingent	MALE
Kontinuität	MALE
Kontinuum	MALE
Konto	MALE
Kontonummer	MALE
Kontor	MALE
Kontra	MALE
Kontrahent	MALE
Kontrakt	MALE
Kontraktabruf	MALE
Kontraktion	MALE
Kontrapunkt	MALE
Kontrast	MALE
Kontrastmittel	MALE
Kontrollbeamt	MALE
Kontrollbehörde	MALE
Kontrolle	MALE
Kontrolleur	MALE
Kontrollfähigkeit	MALE
Kontrollgremium	MALE
Kontrollgruppe	MALE
Kontrollkommission	MALE
Kontrollmandat	MALE
Kontrollmangel	MALE
Kontrollmechanismus	MALE
Kontrollpunkt	MALE
Kontrollraum	MALE
Kontrollsystem	MALE
Kontrollzentrum	MALE
Kontroverse	MALE
Kontur	MALE
Konvent	MALE
Konvention	MALE
Konventionalität	MALE
Konvergenz	MALE
Konvergenzkriterium	MALE
Konversation	MALE
Konversion	MALE
Konvertibilität	MALE
Konvoi	MALE
Konvulsion	MALE
Konzentrat	MALE
Konzentration	MALE
Konzentrationsfähigkeit	MALE
Konzentrationslager	MALE
Konzentrationsphantasie	MALE
Konzentrationsprozeß	MALE
Konzentrierung	MALE
Konzept	MALE
Konzeption	MALE
Konzern	MALE
Konzern-	MALE
Konzernbelegschaft	MALE
Konzernbereich	MALE
Konzernbesitzer	MALE
Konzernbetriebsergebnis	MALE
Konzernboss	MALE
Konzernchef	MALE
Konzerndienst	MALE
Konzernentwicklung	MALE
Konzernergebnis	MALE
Konzernführung	MALE
Konzerngewinn	MALE
Konzerngremium	MALE
Konzernleistung	MALE
Konzernleitung	MALE
Konzernmanager	MALE
Konzernrechnung	MALE
Konzernschwerpunkt	MALE
Konzernsparte	MALE
Konzernspitze	MALE
Konzernsprecher	MALE
Konzernstab	MALE
Konzernumsatz	MALE
Konzernverbund	MALE
Konzernverlust	MALE
Konzernvorstand	MALE
Konzernzahl	MALE
Konzernzentrale	MALE
Konzernüberschuß	MALE
Konzert	MALE
Konzertbetrieb	MALE
Konzertgänger	MALE
Konzerthalle	MALE
Konzerthaus	MALE
Konzerthörer	MALE
Konzertkarte	MALE
Konzertprogramm	MALE
Konzertreihe	MALE
Konzertsaal	MALE
Konzertsaison	MALE
Konzertserie	MALE
Konzertveranstalter	MALE
Konzession	MALE
Konzessionär	MALE
Konzil	MALE
Kooperation	MALE
Kooperationsabkommen	MALE
Kooperationsbereitschaft	MALE
Kooperationsbeziehung	MALE
Kooperationspartner	MALE
Kooperationsprojekt	MALE
Kooperationsvereinbarung	MALE
Kooperationsvertrag	MALE
Koordinate	MALE
Koordinatenkreuz	MALE
Koordinatensystem	MALE
Koordination	MALE
Koordinationsbüro	MALE
Koordinationszentrum	MALE
Koordinator	MALE
Koordinierung	MALE
Koordinierungsprogramm	MALE
Koordinierungsschwierigkeit	MALE
Koordinierungsstelle	MALE
Kosmetik	FEMALE
Kosmetikhersteller	FEMALE
Kosmetikmanagerin	FEMALE
Kosmologie	FEMALE
Kosmonaut	FEMALE
Kosmos	FEMALE
Krankenhausaufenthalt	MALE
Krankenhausgesellschaft	MALE
Krankenhausrechnung	MALE
Krankenhaussprecher	MALE
Krankenhausträger	MALE
Krankenkasse	MALE
Krankenkassenbeitrag	MALE
Krankenpflege	MALE
Krankenpfleger	MALE
Krankenschwester	MALE
Krankensparte	MALE
Krankenstand	MALE
Krankenstation	MALE
Krankenversicherer	MALE
Krankenversichert	MALE
Krankenversicherung	MALE
Krankenversicherungsbeitrag	MALE
Krankenversorgung	MALE
Krankenwagen	MALE
Krankheit	MALE
Krankheitsbild	MALE
Krankheitserreger	MALE
Krankheitserscheinung	MALE
Krankheitsfall	MALE
Krankheitskosten	MALE
Krankheitstag	MALE
Krankheitsverlauf	MALE
Krankheitszeichen	MALE
Krankmeldung	MALE
Kranz	MALE
Kranzniederlegung	MALE
Krater	MALE
Kraut	MALE
Krawall	MALE
Krawatte	MALE
Kreation	MALE
Kreativität	MALE
Kreativitätsschub	MALE
Kreatur	MALE
Krebs	MALE
Krebsart	MALE
Krebsbekämpfung	MALE
Krebserkrankung	MALE
Krebsforscher	MALE
Krebsgesellschaft	MALE
Krebshilfe	MALE
Krebspatient	MALE
Krebsrisiko	MALE
Krebsspezialist	MALE
Krebsursachenforschung	MALE
Krebszelle	MALE
Kredit	MALE
Kredit-	MALE
Kreditanstalt	MALE
Kreditantrag	MALE
Kreditaufnahme	MALE
Krediterleichterung	MALE
Kreditfähigkeit	MALE
Kreditgeber	MALE
Kreditgenosse	MALE
Kreditgeschäft	MALE
Kreditgewährung	MALE
Kreditinstitut	MALE
Kreditkarte	MALE
Kreditkartenbesitzer	MALE
Kreditkartengrösse	MALE
Kreditkartenkonto	MALE
Kreditlinie	MALE
Kreditmarkt	MALE
Kreditnehmer	MALE
Kreditneuzusage	MALE
Kreditpaket	MALE
Kreditressort	MALE
Kreditvergabe	MALE
Kreditvertrag	MALE
Kreditvolumen	MALE
Kreditwesen	MALE
Kreditwirtschaft	MALE
Kreditwürdigkeit	MALE
Kreditzügel	MALE
Kreide	FEMALE
Kreis	FEMALE
Kreisausschuss	FEMALE
Kreisbeigeordnet	FEMALE
Kreisbereisung	FEMALE
Kreisform	FEMALE
Kreisgebiet	FEMALE
Kreisgericht	FEMALE
Kreisjugendpfleger	FEMALE
Kreisklasse	FEMALE
Kreislauf	FEMALE
Kreislaufforscher	FEMALE
Kreislaufversagen	FEMALE
Kreislaufwirtschaft	FEMALE
Kreisliga	FEMALE
Kreisliga-	FEMALE
Kreisparteitag	FEMALE
Kreissparkasse	FEMALE
Kreisstadt	FEMALE
Kreissäge	FEMALE
Kreistag	FEMALE
Kreisverband	FEMALE
Kreisvergleich	FEMALE
Kreisverkehr	FEMALE
Kreisverwaltung	FEMALE
Kreiswehrersatzamt	FEMALE
Krisenzeit	FEMALE
Krisenüberwindung	FEMALE
Kuchen	MALE
Kugelschreiber	MALE
Kuh	MALE
Kultur	FEMALE
Kulturaktivität	FEMALE
Kulturamt	FEMALE
Kulturangebot	FEMALE
Kulturarbeit	FEMALE
Kulturausgabe	FEMALE
Kulturaustausch	FEMALE
Kulturbanause	FEMALE
Kulturbeflissen	FEMALE
Kulturbereich	FEMALE
Kulturbesitz	FEMALE
Kulturbetrieb	FEMALE
Kulturbund	FEMALE
Kulturdachverband	FEMALE
Kulturdenkmal	FEMALE
Kulturdezernent	FEMALE
Kulturdezernentin	FEMALE
Kulturdiskussion	FEMALE
Kultureinrichtung	FEMALE
Kulturforum	FEMALE
Kulturfreak	FEMALE
Kulturfunktionär	FEMALE
Kulturförderung	FEMALE
Kulturgeschichte	FEMALE
Kulturgut	FEMALE
Kulturhauptstadt	FEMALE
Kulturhaus	FEMALE
Kulturhochburg	FEMALE
Kulturinformationszentrum	FEMALE
Kulturinitiative	FEMALE
Kulturinstitut	FEMALE
Kulturkalender	FEMALE
Kulturkampf	FEMALE
Kulturkreis	FEMALE
Kulturlandschaft	FEMALE
Kulturleben	FEMALE
Kulturminister	FEMALE
Kulturministerium	FEMALE
Kulturpflanze	FEMALE
Kulturpolitik	FEMALE
Kulturprogramm	FEMALE
Kulturprojekt	FEMALE
Kulturrat	FEMALE
Kulturraum	FEMALE
Kulturreise	FEMALE
Kulturrevolution	FEMALE
Kulturrummel	FEMALE
Kulturschaffender	FEMALE
Kulturschatz	FEMALE
Kultursenator	FEMALE
Kulturstaatsministerin	FEMALE
Kulturstiftung	FEMALE
Kulturstätte	FEMALE
Kulturtourismus	FEMALE
Kulturveranstaltung	FEMALE
Kulturverein	FEMALE
Kulturwandel	FEMALE
Kulturwissenschaft	FEMALE
Kulturzentrum	FEMALE
Kultus	FEMALE
Kultusgemeinde	FEMALE
Kultusminister	FEMALE
Kultusministerin	FEMALE
Kultusministerium	FEMALE
Kultusministerkonferenz	FEMALE
Kümmel	MALE
Kündigung	MALE
Kündigungsgrund	MALE
Kündigungsrecht	MALE
Kündigungsschutz	MALE
KündigungsschutzKlage	MALE
Kündigungsschutzgesetz	MALE
Kündung	MALE
Landschaft	FEMALE
Landschaftsarchitektur	FEMALE
Landschaftsbild	FEMALE
Landschaftspflege	FEMALE
Landschaftsplanung	FEMALE
Landschaftsraum	FEMALE
Landschaftsschutz	FEMALE
Landschaftsschutzgebiet	FEMALE
Lebenserfahrung	FEMALE
Lebenserhaltungskoste	FEMALE
Lebenserleichterung	FEMALE
Lebenserwartung	FEMALE
Lebensform	FEMALE
Lebensfreude	FEMALE
Lebensführung	FEMALE
Lebensgefahr	FEMALE
Lebensgefährte	FEMALE
Lebensgefährtin	FEMALE
Lebensgefühl	FEMALE
Lebensgemeinschaft	FEMALE
Lebensgeschichte	FEMALE
Lebensgestaltung	FEMALE
Lebensgewohnheit	FEMALE
Lebensgrundlage	FEMALE
Lebenshaltung	FEMALE
Lebenshaltungskoste	FEMALE
Lebenshilfe	FEMALE
Lebensjahr	FEMALE
Lebenskraft	FEMALE
Lebenslage	FEMALE
Lebenslauf	FEMALE
Lebensleistung	FEMALE
Lebenslust	FEMALE
Lebensraum	MALE
Lebensrecht	MALE
Lebensretter	MALE
Lebensschützer	MALE
Lebenssinn	MALE
Lebenssituation	MALE
Lebenssparte	MALE
Lebenssplitter	MALE
Lebensstandard	MALE
Lebensstation	MALE
Lebensstil	MALE
Lebensstruktur	MALE
Lebenstaktik	MALE
Lebenstraum	MALE
Lebensumfeld	MALE
Lebensumstand	MALE
Lebensunterhalt	MALE
Lebensverhältnis	MALE
Lebensverlängerung	MALE
Lebensversicherer	MALE
Lebensversicherung	MALE
Lebensversicherungstochter	MALE
Lebenswandel	MALE
Lebensweg	MALE
Lebensweise	MALE
Lebensweisheit	MALE
Lebenswelt	MALE
Lebenswerk	MALE
Lebenswirklichkeit	MALE
Lebenswissenschaft	MALE
Lebenszeichen	MALE
Lebenszeit	FEMALE
Lebenszyklus	FEMALE
Leber	FEMALE
Leberzelle	FEMALE
Lebewesen	FEMALE
Lebtag	FEMALE
Lebzeit	FEMALE
Lehrzeit	FEMALE
Leib	FEMALE
Leibeigenschaft	FEMALE
Leibeskraft	FEMALE
Leibesvisitation	FEMALE
Leiharbeit	FEMALE
Leiharbeiter	FEMALE
Leihmanager	FEMALE
Leim	MALE
Leitkultur	FEMALE
Leitlinie	FEMALE
Leitmelodie	FEMALE
Leitmotiv	FEMALE
Leitplanke	FEMALE
Leitsatz	FEMALE
Leitstand	FEMALE
Leitstelle	FEMALE
Leitsystem	FEMALE
Leitung	FEMALE
Leitungsbesitzer	FEMALE
Leitungsfunktion	FEMALE
Lernkultur	FEMALE
Lernort	FEMALE
Lernprogramm	FEMALE
Lernprozess	FEMALE
Lernsituation	FEMALE
Live-	FEMALE
Lobbyarbeit	FEMALE
Lobbyist	FEMALE
Lobbytätigkeit	FEMALE
Lobeshymne	FEMALE
Loblied	FEMALE
Lohnarbeit	FEMALE
Lohnausgleich	FEMALE
Lohndumping	FEMALE
Lohnempfänger	FEMALE
Lohnerhöhung	FEMALE
Lohnersatzleistung	FEMALE
Lohnforderung	FEMALE
Lohnfortzahlung	FEMALE
Lohngruppe	FEMALE
Lohnkosten	FEMALE
Lohnkostenanteil	FEMALE
Lohnkostenzuschuß	FEMALE
Lohnpfändung	FEMALE
Lohnpolitik	FEMALE
Lohnrunde	FEMALE
Lohnschraube	FEMALE
Lohnsteuer	FEMALE
Lohnsteuerkarte	FEMALE
Lohnstückkosten	FEMALE
Lohnsubvention	FEMALE
Lohnunterschied	FEMALE
Lohnzurückhaltung	FEMALE
Lohnzusatzkosten	FEMALE
Loipe	FEMALE
Lok	FEMALE
Lokal	FEMALE
Lokalfernsehen	FEMALE
Lokalisierung	FEMALE
Lokalität	FEMALE
Lokalrundschau	FEMALE
Lokomotive	FEMALE
Luft	FEMALE
Luftangriff	FEMALE
Luftangriffsmission	FEMALE
Luftballon	FEMALE
Luftbelastungswert	FEMALE
Luftbildarchäologie	FEMALE
Luftbuchung	FEMALE
Luftdruck	FEMALE
Luftfahrt	FEMALE
Luftfahrt-	FEMALE
Luftfahrt-	FEMALE
Luftfahrtchef	FEMALE
Luftfahrtexperte	FEMALE
Luftfahrtgesellschaft	FEMALE
Luftfahrtindustrie	FEMALE
Luftfahrtkenner	FEMALE
Luftfahrtkonzern	FEMALE
Luftfeuchtigkeit	FEMALE
Lufthansa-	FEMALE
Lufthansa-	FEMALE
Lufthansa-	FEMALE
Lufthansa-	FEMALE
Lufthoheitsgebiet	FEMALE
Luftholen	FEMALE
Luftlinie	FEMALE
Luftnummer	FEMALE
Luftpirat	FEMALE
Luftqualität	FEMALE
Luftraum	FEMALE
Luftschnittstelle	FEMALE
Luftsprung	FEMALE
Lufttemperatur	FEMALE
Lufttransport	FEMALE
Lufttransportkapazität	FEMALE
Luftunterstützung	FEMALE
Luftverkehr	FEMALE
Luftverkehrsbestimmung	FEMALE
Luftverkehrspolitik	FEMALE
Luftverkehrssicherheit	FEMALE
Luftverpester	FEMALE
Luftverschmutzung	FEMALE
Luftwaffe	FEMALE
Luftwaffengeneral	FEMALE
Luftwaffenoffizier	FEMALE
Luftwaffenstützpunkt	FEMALE
Luftweg	FEMALE
Luftwiderstand	FEMALE
Luftüberwachung	FEMALE
Länderebene	FEMALE
Ländergesellschaft	FEMALE
Länderkammer	FEMALE
Länderkunde	FEMALE
Länderminister	FEMALE
Länderranking	FEMALE
Länderspiel	FEMALE
Länge	FEMALE
Madame	FEMALE
Made	FEMALE
Malz	MALE
Malzeug	MALE
Mama	MALE
Mami	MALE
Mammutaktion	MALE
Mammutbetrieb	MALE
Mammutprojekt	MALE
Mammutturnier	MALE
Management	MALE
Management-	MALE
Management-	MALE
Managementbegriff	MALE
Managementberatung	MALE
Managementfehler	MALE
Managementkatechismus	MALE
Managementkultur	MALE
Managementlehrbuch	MALE
Managementleistung	MALE
Managementmethode	MALE
Managementphilosophie	MALE
Managementprinzip	MALE
Managementrezept	MALE
Managementschule	MALE
Managementveränderung	MALE
Managementwissen	MALE
Manager	MALE
Manager-	MALE
Managerprofil	MALE
Managertreffen	MALE
Managerwelt	MALE
Margarine	FEMALE
Mark	FEMALE
Markdorfer	FEMALE
Marke	FEMALE
Markenartikel	FEMALE
Markenartikler	FEMALE
Markenname	FEMALE
Markenprofiteur	FEMALE
Markenzeichen	FEMALE
Marketing	FEMALE
Marketing-	FEMALE
Marketing-	FEMALE
Marketing-	FEMALE
Marketing-	FEMALE
Marketing-	FEMALE
Marketingbereich	FEMALE
Marketingchef	FEMALE
Marketingerfahrung	FEMALE
Marketinggesellschaft	FEMALE
Marketingkosten	FEMALE
Marketingleiter	FEMALE
Marketingstratege	FEMALE
Markgraf	FEMALE
Markierung	FEMALE
Marmelade	FEMALE
Marmeladenharmonisierung	FEMALE
Marmor	MALE
Marmor-	MALE
Marokkaner	MALE
Masern	FEMALE
Materie	FEMALE
Mathematikunterricht	MALE
Mazedonien	MALE
Mbna-	MALE
Medienarbeit	FEMALE
Medienbereich	FEMALE
Medienbericht	FEMALE
Medienbranche	FEMALE
Medienentwicklung	FEMALE
Medienerziehung	FEMALE
Medienexperte	FEMALE
Mediengesellschaft	FEMALE
Medienhaus	FEMALE
Medienkompetenz	FEMALE
Medienkonzern	FEMALE
Medienkultur	FEMALE
Medienkunst	FEMALE
Medienlandschaft	FEMALE
Mediennutzung	FEMALE
Medienpolitik	FEMALE
Medienpreis	FEMALE
Medienpädagogik	FEMALE
Medienrummel	FEMALE
Medienstruktur	FEMALE
Medientheater	FEMALE
Medienunternehmen	FEMALE
Medienunternehmer	FEMALE
Medienverbreitung	FEMALE
Medienvertreter	FEMALE
Medienwelt	FEMALE
Medienwirtschaft	FEMALE
Medienwissenschaft	FEMALE
Medienwissenschaftler	FEMALE
Medienzeitalter	FEMALE
Medienzentrum	FEMALE
Medikament	FEMALE
Medikamentenbedarf	FEMALE
Medikamentenprüfung	FEMALE
Medikation	FEMALE
Meinung	FEMALE
Meinungsaustausch	FEMALE
Meinungsbildung	FEMALE
Meinungsforscher	FEMALE
Meinungsforschungsinstitut	FEMALE
Meinungsfreiheit	FEMALE
Meinungsgegensatz	FEMALE
Meinungsmacher	FEMALE
Meinungsumfrage	FEMALE
Meinungsunterschied	FEMALE
Meinungsverschiedenheit	FEMALE
Meinungsvielfalt	FEMALE
Meinungswandel	FEMALE
Meinungsäußerung	FEMALE
Miami	MALE
Migrant	FEMALE
Migrantin	FEMALE
Migration	FEMALE
Migrationsbewegung	FEMALE
Migrationshintergrund	FEMALE
Migrationspolitik	FEMALE
Migräne	FEMALE
Minister	MALE
Ministerialdirigent	MALE
Ministerin	FEMALE
Ministerin	MALE
Ministerium	FEMALE
Ministeriumssprecherin	FEMALE
Ministerpräsident	FEMALE
Ministerpräsident	FEMALE
Ministerpräsidentengehalt	FEMALE
Ministerpräsidentenkonferenz	FEMALE
Ministerpräsidentin	FEMALE
Ministerrang	FEMALE
Ministerrat	FEMALE
Ministerratssitzung	FEMALE
Ministerriege	FEMALE
Ministertreffen	FEMALE
Mittagsruhe	FEMALE
Mittagstermin	FEMALE
Mittagstisch	FEMALE
Mittagszeit	FEMALE
Mittwoch	MALE
Mittwochstermin	MALE
Mittäterschaft	MALE
Mitverantwortung	MALE
Mitwirkend	MALE
Mitwirkung	MALE
Mitwohngelegenheit	MALE
Mix	MALE
Mixtur	MALE
Mißbilligung	MALE
Mißbilligungserklärung	MALE
Mißbrauchsbekämpfung	MALE
Mißernte	MALE
Mißhandlung	MALE
Mißhelligkeit	MALE
Mißliebigkeit	MALE
Mißstand	MALE
Mißverhältnis	MALE
Mißwirtschaft	MALE
Monsieur	MALE
Montag	MALE
Montagabend	MALE
Montagausgabe	MALE
Montage	MALE
Montagelinie	MALE
Montageraum	MALE
Montagewerk	MALE
Montagmorgen	MALE
Montags-	MALE
Montagsdemo	MALE
Montagsdemonstration	MALE
Montan-	MALE
Montanindustrie	MALE
Montanmitbestimmung	MALE
Montevideo	MALE
Musik	FEMALE
Musikangebot	FEMALE
Musikanlage	FEMALE
Musikant	FEMALE
Musikdarbietung	FEMALE
Musiker	FEMALE
Musikergestalt	FEMALE
Musikerin	FEMALE
Musikerkreis	FEMALE
Musikfilm	FEMALE
Musikgeschichte	FEMALE
Musikgeschäft	FEMALE
Musikhochschule	FEMALE
Musikideologie	FEMALE
Musikindustrie	FEMALE
Musikinstrument	FEMALE
Musikinstrumentenbauer	FEMALE
Musikkanal	FEMALE
Musikkapelle	FEMALE
Musikkapelle	FEMALE
Musikphänomen	FEMALE
Musikpublizist	FEMALE
Musikpädagoge	FEMALE
Musikpädagogik	FEMALE
Musikrat	FEMALE
Musikschule	FEMALE
Musikstudent	FEMALE
Musikstudium	FEMALE
Musikstück	FEMALE
Musikszene	FEMALE
Musiktag	FEMALE
Musiktheater	FEMALE
Musiktherapie	FEMALE
Musikunterricht	MALE
Musikverein	MALE
Musikwissenschaft	MALE
Musikwissenschaftler	MALE
Musikzeitung	MALE
Möglichkeit	FEMALE
Möhre	FEMALE
Mönch	FEMALE
Nachbarschaft	FEMALE
Nachbarschaftsbüro	FEMALE
Nachbarschaftshilfe	FEMALE
Nachbarschaftsinformation	FEMALE
Nachbarschaftszentrum	FEMALE
Nachbarschaftszwist	FEMALE
Nachbarstaat	FEMALE
Nachbarstadt	FEMALE
Nachbeben	FEMALE
Nachbereitung	FEMALE
Nachbereitungstreffen	FEMALE
Nachbesetzung	FEMALE
Nachbesprechung	FEMALE
Nachdenklichkeit	FEMALE
Nachdruck	FEMALE
Nachfahre	FEMALE
Nachfolge	FEMALE
Nachfolgebehörde	FEMALE
Nachfolgebetrieb	FEMALE
Nachfolgebuch	FEMALE
Nachfolgekandidat	FEMALE
Nachfolgemodell	FEMALE
Nachfolgeorganisation	FEMALE
Nachfolgeprozeß	FEMALE
Nachfolger	FEMALE
Nachfolgerin	FEMALE
Nachfolgesituation	FEMALE
Nachfolgestaat	FEMALE
Nachforschung	FEMALE
Nachfrage	FEMALE
Nachfragedruck	FEMALE
Nachfragepolitik	FEMALE
Nachfragerückgang	FEMALE
Nachfrageseite	FEMALE
Nachhaltigkeit	FEMALE
Nachhaltigkeitsstrategie	FEMALE
Nachhauseweg	FEMALE
Nachhilfe	FEMALE
Nachhilfeunterricht	MALE
Nachhinein	MALE
Nachholbedarf	MALE
Nachholen	MALE
Nachkommenschaft	MALE
Nachkriegsgeschichte	MALE
Nachkriegsmonat	MALE
Nachkriegsordnung	MALE
Nachkriegsregierung	MALE
Nachkriegszeit	MALE
Nachlass	MALE
Nachlässigkeit	MALE
Nachmittags-	MALE
Nachmittagsbereich	MALE
Nachmittagsprogramm	MALE
Nachmittagstermin	MALE
Nachnahme	FEMALE
Nachname	FEMALE
Nachpinselung	FEMALE
Nachqualifizierung	FEMALE
Nachricht	FEMALE
Nachricht	FEMALE
Nachrichtenagentur	FEMALE
Nachrichtenclip	FEMALE
Nachrichtendienst	FEMALE
Nachrichtenempfang	FEMALE
Nachrichtenfaktor	FEMALE
Nachrichteninhalt	FEMALE
Nachrichtenkanal	FEMALE
Nachrichtenmagazin	FEMALE
Nachrichtenmedium	FEMALE
Nachrichtenmeldung	FEMALE
Nachrichtenredaktion	FEMALE
Nachrichtensatellit	FEMALE
Nachrichtensender	FEMALE
Nachrichtensendung	FEMALE
Nachrichtenwesen	FEMALE
Nachrichtenübermittlung	FEMALE
Nachruf	FEMALE
Nachrüstung	FEMALE
Nachrüstungsplan	FEMALE
Nachsaison	FEMALE
Nachsatz	FEMALE
Nachschlagewerk	FEMALE
Nachschub	FEMALE
Nachsteuergewinn	FEMALE
Nachtarbeit	FEMALE
Nachtbar	FEMALE
Nachtclub	FEMALE
Nachteil	MALE
Nachtexpress	MALE
Nachtflug	MALE
Nachthimmel	MALE
Nachtigall	MALE
Nachtleben	MALE
Nachtmusik	MALE
Nachtprogramm	MALE
Nachtragsetat	MALE
Nachtragshaushalt	MALE
Nachtreffen	MALE
Nachtzeit	FEMALE
Nachtzug	FEMALE
Nachtzuschlag	FEMALE
Nachvollzug	FEMALE
Nachwahl	FEMALE
Nachweis	FEMALE
Nachweisdefizit	FEMALE
Nachwirkung	FEMALE
Nachwuchs	FEMALE
Nachwuchs-	FEMALE
Nachwuchs-	FEMALE
Nachwuchsarbeit	FEMALE
Nachwuchsfestival	FEMALE
Nachwuchsförderung	FEMALE
Nachwuchskraft	FEMALE
Nachwuchskünstler	FEMALE
Nachwuchsmangel	FEMALE
Nachwuchssorge	FEMALE
Nachwuchsspielerin	FEMALE
Nachwuchswissenschaftler	FEMALE
Nachzahlung	FEMALE
Nachzügler	FEMALE
Nacken	FEMALE
Nackt-	FEMALE
Nacktfotos	FEMALE
Nadel	FEMALE
Nadelstreifen	FEMALE
Nancy	FEMALE
Naturstein	MALE
Natursteinart	MALE
Natursteinhaus	MALE
Naturstrasse	MALE
Naturtalent	MALE
Natururlaub	MALE
Naturvielfalt	MALE
Naturwanderung	MALE
Naturwissenschaft	MALE
Naturwissenschaftler	MALE
Naturwunder	MALE
Natürschützer	MALE
Nazizeit	FEMALE
Nebel	MALE
Nebenabsprache	MALE
Nebenbestimmung	MALE
Nebeneffekt	MALE
Nebeneinkunft	MALE
Nebenerwerbsbauer	MALE
Nebenerwerbswinzer	MALE
Nebenfach	MALE
Nebengebäude	MALE
Nebengeschäft	MALE
Nebenjob	MALE
Nebenkläger	MALE
Nebenkoste	MALE
Nebenläufe	MALE
Nebenprodukt	MALE
Nebenraum	MALE
Nebenrolle	MALE
Nebensache	MALE
Nebensaison	MALE
Nebentätigkeit	MALE
Nebenwert	MALE
Nebenwirkung	MALE
Nektar	MALE
Nelke	MALE
Nemesis	MALE
Notwendigkeit	FEMALE
OSLO	MALE
Option	FEMALE
Optionsvertrag	FEMALE
Opus	FEMALE
Orangensaft	MALE
Orangerie	MALE
Osteoporose	FEMALE
Oster-	FEMALE
Osterdienstag	FEMALE
Osterfeiertag	FEMALE
Osterferien	FEMALE
Osterfest	FEMALE
Osterglocke	FEMALE
Ostseeraum	MALE
Parmesan	MALE
Parodie	MALE
Parole	MALE
Pasta	FEMALE
Paste	FEMALE
Pasteur-	FEMALE
Pastor	FEMALE
Pate	FEMALE
Patenschaft	FEMALE
Patent	FEMALE
Patentamt	FEMALE
Patentanmeldung	FEMALE
Patentierbarkeit	FEMALE
Patentierung	FEMALE
Patentlösung	FEMALE
Patentrezept	FEMALE
Patentstatistik	FEMALE
Pater	FEMALE
Pathologie	FEMALE
Pathos	FEMALE
Phosphor	MALE
Phosphorpunkt	MALE
Photo	MALE
Photo-	MALE
Photodrucker	MALE
Photografie	MALE
Photograph	MALE
Photographie	MALE
Photon	MALE
Photosynthese	MALE
Photovoltaik	MALE
Photovoltaikanlage	MALE
Phrase	MALE
Phrasierung	MALE
Pionierarbeit	FEMALE
Pionierfach	FEMALE
Pionierunternehmen	FEMALE
Platz	MALE
Platzangebot	MALE
Platzauslastung	MALE
Platzbedarf	MALE
Platzen	MALE
Platzgrund	MALE
Platzhalter	MALE
Platzherr	MALE
Platzhirsch	MALE
Platzierung	MALE
Platzkarte	MALE
Platzkonzert	MALE
Platzmangel	MALE
Platznutzung	MALE
Platzverhältnis	MALE
Platzverteilung	MALE
Platzverweis	MALE
Pn_type_date	MALE
Pn_type_percentage	MALE
Polizeigewahrsam	MALE
Polizeigewalt	MALE
Polizeigewerkschaft	MALE
Polizeiinspektion	MALE
Polizeikontrolle	MALE
Polizeikraft	MALE
Polizeikreis	MALE
Polizeikritiker	MALE
Polizeiminister	MALE
Polizeioffizier	MALE
Polizeipraktik	MALE
Polizeipraxis	MALE
Polizeipräfekt	MALE
Polizeipräsident	MALE
Polizeipräsidium	MALE
Polizeirecht	MALE
Polizeirevier	MALE
Polizeisprecher	MALE
Polizeistation	MALE
Polizeistunde	MALE
Polizeitaktiker	MALE
Polizeiverständnis	MALE
Polizeiverwaltung	MALE
Polizeivorgehen	MALE
Polizeiwache	MALE
Polizeiwagen	MALE
Polizist	MALE
Polizistin	MALE
Pommes	FEMALE
Pommesbude	FEMALE
Poollandschaft	FEMALE
Pop-	FEMALE
Pop-	FEMALE
Popbranche	FEMALE
Popindustrie	FEMALE
Popkultur	FEMALE
Popmusik	FEMALE
Portwein	MALE
Pressearbeit	FEMALE
Pressebericht	FEMALE
Professor	MALE
Professorin	MALE
Professur	MALE
Profi	MALE
Profiabteilung	MALE
Profil	MALE
Profilbildung	MALE
Profilierung	MALE
Profit	MALE
Profitmotiv	MALE
Profitrate	MALE
Projektarbeit	FEMALE
Projektbeschreibung	FEMALE
Projektbesprechung	FEMALE
Projektentwickler	FEMALE
Projektentwicklung	FEMALE
Projektförderung	FEMALE
Projektgruppe	FEMALE
Projektil	FEMALE
Projektion	FEMALE
Projektionsfläche	FEMALE
Projektkoordinator	FEMALE
Projektleiter	FEMALE
Projektleiter-	FEMALE
Projektleiterin	FEMALE
Projektleitersitzung	FEMALE
Projektleitung	FEMALE
Projektmanagement	FEMALE
Projektmanager	FEMALE
Projektpartner	FEMALE
Projektteam	FEMALE
Projektträger	FEMALE
Projektvolumen	FEMALE
Projektwerkstatt	FEMALE
Proklamation	FEMALE
Prokurist	FEMALE
Proletariat	FEMALE
Proletarier	FEMALE
Proliferation	FEMALE
Prolog	FEMALE
Promenade	FEMALE
Promi	FEMALE
Prominent	FEMALE
Prominenz	FEMALE
Promotion	FEMALE
Pronomen	FEMALE
Propaganda	FEMALE
Propagandaorgan	FEMALE
Propagandasender	FEMALE
Propagierung	FEMALE
Propangasheizung	FEMALE
Prophet	FEMALE
Propheten-	FEMALE
Prophetie	FEMALE
Prophezeiung	FEMALE
Prophylaxe	FEMALE
Proportion	FEMALE
Propst	FEMALE
Propsteihaus	FEMALE
Prunkanlage	FEMALE
Prüfungsarbeit	FEMALE
Prüfungsaufgabe	FEMALE
Prüfungsausschuss	FEMALE
Prüfungsfach	FEMALE
Prüfungsleistung	FEMALE
Prüfungsordnung	FEMALE
Prüfungsteilnehmer	FEMALE
Prüfungstermin	FEMALE
Prüfungstätigkeit	FEMALE
Prüfungsverfahren	FEMALE
Prüfungsvorbereitung	FEMALE
Puderzucker	MALE
Pünktchen	MALE
Pünktlichkeit	MALE
Quarantäne	FEMALE
Quark	MALE
Querstrich	MALE
Querstrich	MALE
Quersubventionierung	MALE
Question	MALE
Raps	MALE
Rathhausplatz	MALE
Raum	MALE
Raumfahrer	MALE
Raumfahrt	MALE
Raumfahrtbehörde	MALE
Raumfahrtengagement	MALE
Raumfahrtfirma	MALE
Raumfahrtindustrie	MALE
Raumfahrtkontrollzentrum	MALE
Raumfahrtkonzern	MALE
Raumfahrttochter	MALE
Raumfahrtunternehmen	MALE
Raumfahrtzentrum	MALE
Raumfähre	MALE
Raumklima	MALE
Raumluft	MALE
Raumordnung	MALE
Raumordnungsverfahren	MALE
Raumpfleger	MALE
Raumplanung	MALE
Raumschiff	MALE
Raumsonde	MALE
Raumstation	MALE
Raumteiler	MALE
Raumtemperatur	MALE
Raumtheater	MALE
Raumzeit	FEMALE
Raupe	FEMALE
Raupenlaufwerk	FEMALE
Rausch	FEMALE
Regierungszeit	FEMALE
Regime	FEMALE
Regimegegner	FEMALE
Regimekandidat	FEMALE
Regimekritiker	FEMALE
Regiment	FEMALE
Regimewechsel	FEMALE
Reisezeit	FEMALE
Reisezeitraum	FEMALE
Reisezentrum	FEMALE
Reiseziel	FEMALE
Reisfeld	FEMALE
Reisgericht	FEMALE
Reisigfeuer	FEMALE
Reisighaufen	FEMALE
Reitausflug	FEMALE
Reiter	FEMALE
Reitferien	FEMALE
Reitmöglichkeit	FEMALE
Reitpferd	FEMALE
Reitprogramm	FEMALE
Reitstall	FEMALE
Reitstunde	FEMALE
Reitunterricht	MALE
Reiz	MALE
Reizbarkeit	MALE
Reizdschungel	MALE
Reizthema	MALE
Reizung	MALE
Reklamation	MALE
Reklame	MALE
Reklamebild	MALE
Reklamehimmel	MALE
Reklamesendung	MALE
Reklametafel	MALE
Rekonstruktion	MALE
Rekonstruktionsvorhaben	MALE
Rekord	MALE
Rekorder	MALE
Rekordergebnis	MALE
Rekordgewinn	MALE
Rekordhöhe	MALE
Rekordinvestition	MALE
Rekordjahr	MALE
Rekordstand	MALE
Rekordtiefstand	MALE
Rekordumsatz	MALE
Rekordverlust	MALE
Rekordvolumen	MALE
Rekordzahl	MALE
Rekrut	MALE
Rekrutierung	MALE
Rektor	MALE
Rektorat	MALE
Rektorenkonferenz	MALE
Rektorentagung	MALE
Rektorin	MALE
Rekurs	MALE
Relais	MALE
Relaisausgang	MALE
Relation	MALE
Relationsextraktion	MALE
Relativierung	MALE
Relativität	MALE
Relativitätstheorie	MALE
Release	MALE
Relegation	MALE
Relegationsauftritt	MALE
Relegationsspiel	MALE
Renovierungsarbeit	FEMALE
Renovierungsbedarf	FEMALE
Rentabilität	FEMALE
Rente	FEMALE
Rentenabschlag	FEMALE
Rentenalter	FEMALE
Rentenangelegenheit	FEMALE
Rentenanspruch	FEMALE
Rentenbeitrag	FEMALE
Rentenbesteuerung	FEMALE
Renteneinkünfte	FEMALE
Rentenfonds	FEMALE
Rentenkasse	FEMALE
Rentenmarkt	FEMALE
Rentenreform	FEMALE
Rentenreformkommission	FEMALE
Rentenregelung	FEMALE
Rentensystem	FEMALE
Rentenversicherung	FEMALE
Rentenversicherungsbeitrag	FEMALE
Rentenversicherungssystem	FEMALE
Rentenversicherungsträger	FEMALE
Rentenüberleitungsgesetz	FEMALE
Rentner	FEMALE
Rentneranteil	FEMALE
Rentnerin	FEMALE
Rentnerkind	FEMALE
Rentnerkriminalität	FEMALE
Rentnerleben	FEMALE
Rockmusik	FEMALE
Rocksänger	FEMALE
Roggen	MALE
Rohstoff	MALE
Rohstoffnutzung	MALE
Rohstoffpreis	MALE
Rohölproduktion	MALE
Rolladen	MALE
Rollbahn	MALE
Rolle	MALE
Rollei-	MALE
Rollei-	MALE
Rollenbestimmung	MALE
Rosmarin	MALE
Rotwein	MALE
Rotweintrinker	MALE
Rubel	MALE
Ruhezeit	FEMALE
Ruhezone	FEMALE
Ruhezustand	FEMALE
Ruhigstellung	FEMALE
Ruhm	FEMALE
Ruß	MALE
Rückenwind	MALE
Rückerstattung	MALE
Rückfahren	MALE
Rückfahrkarte	MALE
Rückfahrmöglichkeit	MALE
Rückfahrt	MALE
Rückfahrt-	MALE
Rückfahrticket	MALE
Rückfall	MALE
Rückfliegen	MALE
Rückflug	MALE
Rückflugzeit	MALE
Rückfrage	MALE
Rückführung	MALE
Rückgabe	MALE
Rückgabeanspruch	MALE
Rückgaberecht	MALE
Rückgang	MALE
Rückgrat	MALE
Rückgriff	MALE
Rückkehr	MALE
Rückkehrrecht	MALE
Rückkoppelung	MALE
Rücklauf	MALE
Rückluss	MALE
Rückmeldung	MALE
Rücknahme	MALE
Rückreise	MALE
Rückreisedokument	MALE
Rückreisemöglichkeit	MALE
Rückreisetermin	MALE
Rückreisewelle	MALE
Rückruf	MALE
Rückrufzeit	MALE
Rückschau	MALE
Rückschlag	MALE
Rückseite	MALE
Rücksendung	MALE
Rücksicht	MALE
Rücksichtnahme	MALE
Rücksichtslosigkeit	MALE
Rücksprache	MALE
Rückstand	MALE
Rückstellung	MALE
Rücktermin	MALE
Rücktritt	MALE
Rücktrittsrecht	MALE
Rückumschlag	MALE
Rückverbindung	MALE
Rückversicherer	MALE
Rückversicherung	MALE
Rückversicherungs-	MALE
Rückversicherungschef	MALE
Rückweg	MALE
Rückzahlung	MALE
Rückzug	MALE
Sachunterricht	MALE
Sachverhalt	MALE
Sachverhandlung	MALE
Sachversicherer	MALE
Sachversicherung	MALE
Sachverstand	MALE
Sachverständig	MALE
Sachverständig	MALE
Sachverständigen-	MALE
Sachverständigengutachten	MALE
Sachverständigenrat	MALE
Sachvorgang	MALE
Sachwalter	MALE
Sachwert	MALE
Sachzuwendung	MALE
Sachzwang	MALE
Safari	FEMALE
Safari-	FEMALE
Safari-	FEMALE
Safaribüchse	FEMALE
Safaripark	FEMALE
Safarireise	FEMALE
Safaritour	FEMALE
Safe	FEMALE
Saft	MALE
Saftbar	MALE
Salat	MALE
Salatbuffet	MALE
Salatschüssel	MALE
Salbe	FEMALE
Salbei	MALE
Samstag	MALE
Samstagabend	MALE
Samstagnachmittag	MALE
Samstagsarbeit	MALE
Samsung-	MALE
Samurai	MALE
Sand	MALE
Sandale	MALE
Sandaustausch	MALE
Sandbelag	MALE
Sandbild	MALE
Sandboard	MALE
Sandboden	MALE
Sandinsel	MALE
Sandkasten	MALE
Sandkiste	MALE
Sandmann	MALE
Sandstrand	MALE
Sandwüste	MALE
Sanftmut	MALE
Schaum	MALE
Schaumweinhersteller	MALE
Schaupieler	MALE
Schauplatz	MALE
Schauprozeß	MALE
Schauspiel	MALE
Schauspielbetrieb	MALE
Schauspielensemble	MALE
Schauspieler	MALE
Schauspielerei	MALE
Schauspielerin	MALE
Schauspielhaus	MALE
Schauspielintendant	MALE
Schausteller	MALE
Scheck	MALE
Scheckheft	MALE
Schiessunterricht	MALE
Schießwettbewerb	MALE
Schießwettkampf	MALE
Schiff	MALE
Schiffahrtsagentur	MALE
Schiffahrtsmagnat	MALE
Schiffahrtsverband	MALE
Schiffbau	MALE
Schiffbruch	MALE
Schifffahrt	MALE
Schiffreise	MALE
Schiffsbaukonzern	MALE
Schiffsbeteiligung	MALE
Schiffschaukel	MALE
Schiffspassage	MALE
Schiffsreise	MALE
Schiffstour	MALE
Schiffstransfer	MALE
Schiffsverbindung	MALE
Schiffszulieferung	MALE
Schiite	MALE
Schikane	MALE
Schild	MALE
Schildbürgerstreich	MALE
Schilddrüse	MALE
Schilderung	MALE
Schildkröte	MALE
Schleim	MALE
Schleimhaut	MALE
Schleimkanal	MALE
Schlick	MALE
Schlossplatz	MALE
Schlummertrunk	MALE
Schlupfwinkel	MALE
Schluss	MALE
Schlussakkord	MALE
Schlussapplaus	MALE
Schlussbericht	MALE
Schlussbestimmung	MALE
Schlussfolgerung	MALE
Schlusslicht	MALE
Schlussmann	MALE
Schlussphase	MALE
Schlusspunkt	MALE
Schlussspurt	MALE
Schlusssteigung	MALE
Schlussstrich	MALE
Schlussuntersuchung	MALE
Schlusswort	MALE
Schlußanmerkung	MALE
Schlußberatung	MALE
Schlußbericht	MALE
Schlußfolgerung	MALE
Schlußpoker	MALE
Schlußsatz	MALE
Schlußstand	MALE
Schlußverkauf	MALE
Schlußzeit	MALE
Schokolade	FEMALE
Schokoriegel	FEMALE
Schreiber	MALE
Schreiberling	MALE
Schreibhaltung	MALE
Schreibmaschine	MALE
Schreibmaschinenkurs	MALE
Schreibmaschinenseite	MALE
Schreibstil	MALE
Schreibsystem	MALE
Schreibtelefon	MALE
Schreibtisch	MALE
Schreibtischecke	MALE
Schreibtischtäter	MALE
Schreibung	MALE
Schreibwarenhersteller	MALE
Schreibweise	MALE
Schrein	MALE
Schulsozialarbeit	FEMALE
Schulsport	FEMALE
Schulstufe	FEMALE
Schulsystem	FEMALE
Schulter	FEMALE
Schulterschluß	FEMALE
Schulterschuss	FEMALE
Schultheatertag	FEMALE
Schultheis	FEMALE
Schulträger	FEMALE
Schultür	FEMALE
Schulung	FEMALE
Schulungsaktivität	FEMALE
Schulungskurs	FEMALE
Schulungsprogramm	FEMALE
Schulungstreffen	FEMALE
Schulungszentrum	FEMALE
Schulunterricht	MALE
Schulverwaltung	MALE
Schulweg	MALE
Schulwegsicherung	MALE
Schulwesen	MALE
Schulzeit	MALE
Schulzentrum	MALE
Schulzweig	MALE
Schwarztinte	FEMALE
Schwarzwaldgipfel	FEMALE
Schwimmunterricht	MALE
Schwindel	MALE
Schwips	MALE
Seitenanfang	MALE
Seitenausgang	MALE
Seitenflügel	MALE
Seitengang	MALE
Seitenhieb	MALE
Seitenlage	MALE
Seitenrand	MALE
Seitensprung	MALE
Seitenstraße	MALE
Seitenvorschub	MALE
Seitenwechsel	MALE
Seitenzahl	MALE
Seitenöffnung	MALE
Sekt	MALE
Sekte	MALE
Sektenführer	MALE
Sektion	MALE
Sektionschef	MALE
Sektionsleiter	MALE
Sektkellerei	MALE
Sektkorken	MALE
Sektmenü	MALE
Sektor	MALE
Sektorengrenze	MALE
Sektorenübergang	MALE
Sekundant	MALE
Sekundarstufe	MALE
Sekundenbruchteil	MALE
Sekundärliteratur	MALE
Selbsterfahrung	FEMALE
Selbstfinanzierung	FEMALE
Selbstfindung	FEMALE
Selbstgefälligkeit	FEMALE
Selbstgerechtigkeit	FEMALE
Selbsthilfe	FEMALE
Selbsthilfe-	FEMALE
Selbsthilfe-	FEMALE
Selbsthilfegruppe	FEMALE
Selbsthilfeorganisation	FEMALE
Selbstironie	FEMALE
Selbstjustiz	FEMALE
Selbstkenntnis	FEMALE
Selbstkostenpreis	FEMALE
Selbstkritik	FEMALE
Selbstlähmung	FEMALE
Selbstmitleid	FEMALE
Selbstmord	FEMALE
Selbstmordanschlag	FEMALE
Selbstmordattentat	FEMALE
Selbstmordattentäter	FEMALE
Selbstmordkommando	FEMALE
Selbstorganisation	FEMALE
Selbstparodie	FEMALE
Selbstporträt	FEMALE
Selbstreflexion	FEMALE
Selbstregelung	FEMALE
Selbstregierung	FEMALE
Selbstreinigungsprozeß	FEMALE
Selbstselektion	FEMALE
Selbstsicherheit	FEMALE
Selbststeuerung	FEMALE
Selbststilisierung	FEMALE
Selbststudium	FEMALE
Selbstständig	FEMALE
Selbstständigkeit	FEMALE
Selbstsucht	FEMALE
Selbsttränke	FEMALE
Selbstuntersuchung	FEMALE
Selbstverantwortung	FEMALE
Selbstverliebtheit	FEMALE
Selbstverpfleger	FEMALE
Selbstverpfleger-	FEMALE
Selbstverpflichtung	FEMALE
Selbstversorger	FEMALE
Selbstversorgung	FEMALE
Selbstverständigung	FEMALE
Selbstverständlichkeit	FEMALE
Selbstverständnis	FEMALE
Selbstverstümmelung	FEMALE
Selbstverteidigung	FEMALE
Selbstvertrauen	FEMALE
Selbstvertretung	FEMALE
Selbstverwaltung	FEMALE
Selbstverwirklichung	FEMALE
Selbstwahrnehmung	FEMALE
Selbstwertgefühl	FEMALE
Selbstwähltelefon	FEMALE
Selbstzahler	FEMALE
Selbstzerfleischung	FEMALE
Selbstzerstörung	FEMALE
Selbstzufriedenheit	FEMALE
Selbstzweck	FEMALE
Selbstzweifel	FEMALE
Selbstüberschätzung	FEMALE
Selektion	FEMALE
Selen	FEMALE
Selenversorgung	FEMALE
Seligkeit	FEMALE
Sellerie	MALE
Seminararbeit	FEMALE
Seminarhaus	FEMALE
Seminarraum	FEMALE
Seminarsitzung	FEMALE
Seminartag	FEMALE
Seminarvortrag	FEMALE
Senf	MALE
Seöbstkontrolle	FEMALE
Sir	MALE
Sirene	MALE
Soja	MALE
Soja-	MALE
Sojabohne	MALE
Solarstrom	MALE
Solartechnologie	MALE
Solarzelle	MALE
Sold	MALE
Soldat	MALE
Soldatenseelsorger	MALE
Soldatenzeit	MALE
Soldatin	MALE
Sommer	MALE
Sommerabend	MALE
Sommerakademie	MALE
Sommeranfang	MALE
Sommerbasis	MALE
Sommerferien	MALE
Sommerfest	MALE
Sommerflugplan	MALE
Sommerkatalog	MALE
Sommerkonzert	MALE
Sommermonat	MALE
Sommernachtstraum	MALE
Sommerpause	MALE
Sommerreise	MALE
Sommerschlußverkauf	MALE
Sommerschmankerl	MALE
Sommerschule	MALE
Sommerschulung	MALE
Sommersemester	MALE
Sommerspiel	MALE
Sommertheater	MALE
Sommerurlaub	MALE
Sommerurlaubsangebot	MALE
Sommervorspiel	MALE
Sommerzeit	MALE
Sonderurlaub	MALE
Sondervermögen	MALE
Sonderverwalter	MALE
Sondervollmacht	MALE
Sonderweg	MALE
Sonderzahlung	MALE
Sonderzeichen	MALE
Sonderzuteilung	MALE
Sondierungsgespräch	MALE
Song	MALE
Songwriter	MALE
Sonn-	MALE
Sonnabend	MALE
Sonne	FEMALE
Sonnenbrand	MALE
Sonnenbrille	MALE
Sonnendach	MALE
Sonneneinstrahlung	MALE
Sonnenenergie	MALE
Sonnenfinsternis	MALE
Sonnengott	MALE
Sonntag	MALE
Sonntagabend	MALE
Sonntagmorgen	MALE
Sonntagszeitung	MALE
Sonntagsöffnung	MALE
Sozialarbeit	FEMALE
Sozialarbeiter	FEMALE
Sozialarbeiterin	FEMALE
Sozialausgabe	FEMALE
Sozialausschuss	FEMALE
Sozialauswahl	FEMALE
Sozialbau	FEMALE
Sozialbeitrag	FEMALE
Sozialbereich	FEMALE
Sozialbetrug	FEMALE
Sozialbezirksvorsteher	FEMALE
Sozialbleibe	FEMALE
Sozialbudget	FEMALE
Sozialdemokrat	FEMALE
Sozialdemokrat	FEMALE
Sozialdemokratie	FEMALE
Sozialdemokratin	FEMALE
Sozialdemokratisierung	FEMALE
Sozialdemokratismus	FEMALE
Sozialdezernent	FEMALE
Sozialdezernentin	FEMALE
Sozialdienst	FEMALE
Sozialerhebung	FEMALE
Sozialfond	FEMALE
Sozialforscher	FEMALE
Sozialforschung	FEMALE
Sozialforum	FEMALE
Sozialgericht	FEMALE
Sozialgeschichte	FEMALE
Sozialgesetzbuch	FEMALE
Sozialgesetzgebung	FEMALE
Sozialhaushalt	FEMALE
Sozialhilfe	FEMALE
Sozialhilfe-	FEMALE
Sozialhilfeaufwand	FEMALE
Sozialhilfeempfänger	FEMALE
Sozialhilfesatz	FEMALE
Sozialhilfeträger	FEMALE
Sozialisation	FEMALE
Sozialisierung	FEMALE
Sozialismus	FEMALE
Sozialist	FEMALE
Sozialistenchef	FEMALE
Sozialkahlschlag	FEMALE
Sozialkasse	FEMALE
Sozialkompetenz	FEMALE
Sozialkonflikt	FEMALE
Sozialkritik	FEMALE
Sozialkunde	FEMALE
Soziallehre	FEMALE
Sozialleistung	FEMALE
Sozialminister	FEMALE
Sozialministerin	FEMALE
Sozialministerium	FEMALE
Sozialordnung	FEMALE
Sozialpartner	FEMALE
Sozialpartnerschaft	FEMALE
Sozialphilosoph	FEMALE
Sozialplan	FEMALE
Sozialpolitik	FEMALE
Sozialpolitiker	FEMALE
Sozialprodukt	FEMALE
Sozialprogramm	FEMALE
Sozialpsychiatrie	FEMALE
Sozialpädagogen	FEMALE
Sozialpädagogik	FEMALE
Sozialrecht	FEMALE
Sozialreform	FEMALE
Sozialschädlichkeit	FEMALE
Sozialsenator	FEMALE
Sozialstaat	FEMALE
Sozialstaatlichkeit	FEMALE
Sozialstaatsreform	FEMALE
Sozialstandard	FEMALE
Sozialstruktur	FEMALE
Sozialstudie	FEMALE
Sozialsystem	FEMALE
Sozialunion	FEMALE
Sozialverband	FEMALE
Sozialverhalten	FEMALE
Sozialversicherung	FEMALE
Sozialversicherungsbeitrag	FEMALE
Sozialversicherungssystem	FEMALE
Sozialversicherungsträger	FEMALE
Sozialverträglichkeit	FEMALE
Sozialwesen	FEMALE
Sozialwissenschaft	FEMALE
Sozialwissenschaftler	FEMALE
Sozialwissenschaftlerin	FEMALE
Sozialwohnung	FEMALE
Sozietät	FEMALE
Sozietätsvertrag	FEMALE
Soziokultur	FEMALE
Soziologe	FEMALE
Soziologie	FEMALE
Spa	FEMALE
Spanischunterricht	MALE
Spanne	MALE
Spannung	MALE
Spannungsbogen	MALE
Spannungseingang	MALE
Spannungsfeld	MALE
Spannungsverhältnis	MALE
Spannungsversorgung	MALE
Spannweite	MALE
Spar-	MALE
Sparaktion	MALE
Sparangebot	MALE
Sparanstrengung	MALE
Sparappell	MALE
Sparbegehrlichkeit	MALE
Sparbemühung	MALE
Sparbuch	MALE
Sparbuchbesitzer	MALE
Spareinlage	MALE
Sparer	MALE
Sparflamme	MALE
Sparförderung	MALE
Spargel	MALE
Sparguthaben	MALE
Sparhaushalt	MALE
Sparkasse	MALE
Sparkassengruppe	MALE
Sparkassenlager	MALE
Sparkassenorganisation	MALE
Sparkassenpräsident	MALE
Sparkassensektor	MALE
Sparkonzept	MALE
Sparkurs	MALE
Sparmaßnahme	MALE
Sparpaket	MALE
Sparplan	MALE
Sparpolitik	MALE
Sparpreis	MALE
Sparprogramm	MALE
Sparquote	MALE
Sparreise	MALE
Sparringspartner	MALE
Sparsamkeit	MALE
Sparsamkeitsgrund	MALE
Sparschaltung	MALE
Speck	MALE
Speichel	MALE
Speicher	MALE
Speicher	MALE
Speicherausstattung	MALE
Speicherbaustein	MALE
Speicherbeheizung	MALE
Speicherchip	MALE
Speichererweiterung	MALE
Speichererweiterungsmodul	MALE
Speicherfabrik	MALE
Speichergrösse	MALE
Speicherkapazität	MALE
Speicherkarte	MALE
Speicherlaufwerk	MALE
Speichermedium	MALE
Speicherplatz	MALE
Speichertechnologie	MALE
Speicherung	MALE
Speicherzugriff	MALE
Speise	MALE
Speisekarte	MALE
Speisenkarte	MALE
Speiseplan	MALE
Speiseraum	MALE
Speiseröhre	MALE
Speisesaal	MALE
Speisewagen	MALE
Speisung	MALE
Spektakel	MALE
Spektrum	MALE
Spekulant	MALE
Spekulation	MALE
Spekulationsbewegung	MALE
Spekulationsgeschäft	MALE
Spekulationswelle	MALE
Spende	MALE
Spendenaktion	MALE
Spendenbescheinigung	MALE
Spendenfreudigkeit	MALE
Spendengeld	MALE
Spendenkonto	MALE
Spendenquittung	MALE
Spendezeit	FEMALE
Spendierhose	FEMALE
Spielzeit	FEMALE
Spiritus	MALE
Spital	MALE
Spitzdach	MALE
Spitze	MALE
Spitzel	MALE
Spitzenbeamt	MALE
Spitzendesigner	MALE
Spitzenerfolg	MALE
Spitzenergebnis	MALE
Spitzenforschung	MALE
Spitzenfunktionär	MALE
Spitzengeschwindigkeit	MALE
Spitzengespräch	MALE
Spitzengremium	MALE
Spitzengruppe	MALE
Spitzeninstitut	MALE
Spitzenkandidat	MALE
Spitzenklasse	MALE
Spitzenklubs	MALE
Spitzenkraft	MALE
Spitzenkünstler	MALE
Spitzenleistung	MALE
Spitzenmanager	MALE
Spitzenmann	MALE
Spitzenorganisation	MALE
Spitzenplatz	MALE
Spitzenpolitik	MALE
Spitzenpolitiker	MALE
Spitzenposition	MALE
Spitzenreiter	MALE
Spitzensatz	MALE
Spitzenspannung	MALE
Spitzenspiel	MALE
Spitzensportler	MALE
Spitzenstellung	MALE
Spitzensteuersatz	MALE
Spitzenverband	MALE
Spitzenverdiener	MALE
Spitzenvertreter	MALE
Spitzenwert	MALE
Spitzenzeiten	MALE
Spitzfindigkeit	MALE
Spitzname	MALE
Splatter	MALE
Sprachraum	MALE
Sprachregelung	MALE
Sprachreise	MALE
Sprachrohr	MALE
Sprachschwierigkeit	MALE
Sprachsteuerung	MALE
Sprachtechnologie	FEMALE
Sprachunterricht	MALE
Staatsgewalt	FEMALE
Staatsgrenze	FEMALE
Staatsgründung	FEMALE
Staatsgut	FEMALE
Staatshaushalt	FEMALE
Staatsinvestor	FEMALE
Staatskanzlei	FEMALE
Staatskanzlei-	FEMALE
Staatskasse	FEMALE
Staatskonzept	FEMALE
Staatskonzern	FEMALE
Staatslinie	FEMALE
Staatsmacht	FEMALE
Staatsmann	FEMALE
Staatsmedium	FEMALE
Staatsminister	FEMALE
Staatsministerin	FEMALE
Staatsministerium	FEMALE
Staatsoberhaupt	FEMALE
Staatsoper	FEMALE
Staatsorchester	FEMALE
Staatsordnung	FEMALE
Staatsorgan	FEMALE
Staatsplanung	FEMALE
Staatspreis	FEMALE
Staatspräsident	FEMALE
Staatsprüfung	FEMALE
Staatsquote	FEMALE
Staatsrat	FEMALE
Staatsrecht	FEMALE
Staatsrechtler	FEMALE
Staatsreform	FEMALE
Staatsregierung	FEMALE
Staatsreligion	FEMALE
Staatssammlung	FEMALE
Staatsschuld	FEMALE
Staatsschutz	FEMALE
Staatssekretariat	FEMALE
Staatssekretär	FEMALE
Staatssekretärin	FEMALE
Staatssekretärskommission	FEMALE
Staatssektor	FEMALE
Staatssicherheit	FEMALE
Staatssicherheitsdienst	FEMALE
Staatssicherheitsgericht	FEMALE
Staatssozialismus	FEMALE
Staatsstreich	FEMALE
Staatsterrorismus	FEMALE
Staatstheater	FEMALE
Staatsunternehmen	FEMALE
Staatsverband	FEMALE
Staatsverbrauch	FEMALE
Staatsverschuldung	FEMALE
Staatsvertrag	FEMALE
Staatswerdung	FEMALE
Staatswesen	FEMALE
Staatswirtschaft	FEMALE
Stab	FEMALE
Stahl	MALE
Stahl-	MALE
Stahlbaufertigung	MALE
Stahlbauindustrie	MALE
Stahlbetrieb	MALE
Stahlbranche	MALE
Stahlfusion	MALE
Stahlhandel	MALE
Stahlhersteller	MALE
Stahlindustrie	MALE
Stahlkocher	MALE
Stahlkonzern	MALE
Stahlpartner	MALE
Stahlprodukt	MALE
Stahlriese	MALE
Stahlwerk	MALE
Stahlwerk	MALE
Stahlwerker	MALE
Startplatz	MALE
Startposition	MALE
Startpunkt	MALE
Startschuss	MALE
Startschwierigkeit	MALE
Startseite	MALE
Startwert	MALE
Startzeit	MALE
Steinkohle	FEMALE
Steinkohlenbergbau	FEMALE
Steinkohlezeche	FEMALE
Steinzeit	FEMALE
Stelle	FEMALE
Stellenabbau	FEMALE
Stellenangebot	FEMALE
Stellenanzeige	FEMALE
Stellenbestand	FEMALE
Stellensperre	FEMALE
Stellenwert	FEMALE
Stellfläche	FEMALE
Stellplatz	FEMALE
Stellung	FEMALE
Stellungnahme	FEMALE
Stellvertreter	FEMALE
Stellvertreterin	FEMALE
Stellvertreterposten	FEMALE
Stellvertretung	FEMALE
Sternenzeit	FEMALE
Sternführung	FEMALE
Sternmarsch	FEMALE
Sternschnuppe	FEMALE
Sternstunde	FEMALE
Sternwarte	FEMALE
Sternzeichen	FEMALE
Stetigkeit	FEMALE
Stickstoff	MALE
Stiefel	MALE
Stiefkind	MALE
Stiefmutter	MALE
Stiefschwester	MALE
Stieftochter	MALE
Stiefvater	MALE
Stiel	MALE
Stierkampf	MALE
Stierprämie	MALE
Stift	MALE
Stifterverband	MALE
Stiftskirche	MALE
Stiftung	MALE
Stiftungs-	MALE
Stiftungsprofessur	MALE
Stiftungsrat	MALE
Stigma	MALE
Stigmatisierung	MALE
Strafraum	MALE
Strafraumhöhe	MALE
Strafrecht	MALE
Strafrechtspflege	MALE
Strafrechtsverfahren	MALE
Strafrechtswissenschaft	MALE
Strafrichter	MALE
Strafsache	MALE
Strafsenat	MALE
Straftat	MALE
Straftatbestand	MALE
Straftäter	MALE
Strafverfahren	MALE
Strafverfolger	MALE
Strafverfolgung	MALE
Strafverfolgungsbehörde	MALE
Strafverteidiger	MALE
Strafvollzug	MALE
Strafzettel	MALE
Strafzoll-	MALE
Strafzumessung	MALE
Strahl	MALE
Strahlenbelastung	MALE
Strahlendosis	MALE
Strahlenschaden	MALE
Strahlenschutz	MALE
Strahlentherapie	MALE
Strahlung	MALE
Strahlungsgürtel	MALE
Strahlungsschaden	MALE
Strand	MALE
Strandabschnitt	MALE
Strandbar	MALE
Strandbereich	MALE
Strandentfernung	MALE
Strandhandtuch	MALE
Strandhaus	MALE
Strandhotel	MALE
Strandkrabbe	MALE
Strandlage	MALE
Strandleben	MALE
Strandleistung	MALE
Strandnähe	MALE
Strandservice	MALE
Strandspaziergang	MALE
Strandspiel	MALE
Strandstrasse	MALE
Strandtauchgang	MALE
Strandtuch	MALE
Strandurlaub	MALE
Strandurlaubsangebot	MALE
Strandurlaubsreise	MALE
Strandvilla	MALE
Strandwanderung	MALE
Strandweg	MALE
Strang	MALE
Strapaze	MALE
Strassenbahnstation	MALE
Strassenbauamt	MALE
Strassenfest	MALE
Strassenkriminalität	MALE
Strassensperrung	MALE
Strassentumult	MALE
Stratege	MALE
Strategie	MALE
Strategiekonzept	MALE
Straße	MALE
Straßenbahn	MALE
Straßenbahnlinie	MALE
Straßenbau	MALE
Straßenbaulast	MALE
Straßenbeleuchtung	MALE
Straßenecke	MALE
Straßengüterverkehr	MALE
Straßenhändler	MALE
Straßenkampf	MALE
Straßennetz	MALE
Straßenrand	MALE
Straßenseite	MALE
Straßenverkehr	MALE
Straßenverkehrsordnung	MALE
Straßenüberfall	MALE
Strich	MALE
Strich	MALE
Strichjunge	MALE
Strick	MALE
Striemen	MALE
Stringenz	MALE
Strippe	MALE
Strittig	MALE
Strom	MALE
Stromabnehmer	MALE
Stromanschluss	MALE
Stromaufnahme	MALE
Stromausfall	MALE
Strombedarf	MALE
Strömung	MALE
Studienarbeit	FEMALE
Studienaufenthalt	FEMALE
Studienbedingung	FEMALE
Studienplatz	MALE
Studienplatzvermittler	MALE
Studienreformziel	MALE
Studienreise	MALE
Studienreisenangebot	MALE
Studienrichtung	MALE
Studiensemester	MALE
Studienverlauf	MALE
Studienzeit	MALE
Studienzeitverkürzung	MALE
Studierbarkeit	MALE
Studierendengehalt	MALE
Studierendenparlament	MALE
Studierendenschaft	MALE
Studio	MALE
Studiobesitzer	MALE
Studiokonzert	MALE
Subkultur	FEMALE
Sylt	MALE
Sylvesterrakete	MALE
Symbiose	MALE
Symbol	MALE
Symbolfigur	MALE
Symbolgehalt	MALE
Symbolik	MALE
Symbolisierung	MALE
Symbolkraft	MALE
Säure	FEMALE
Tabak	MALE
Tabakgartenhund	MALE
Tabakgenuss	MALE
Tabaksteuer	MALE
Tabakware	MALE
Tabelle	MALE
Tabellenbereich	MALE
Tabellenführer	MALE
Tabellenplatz	MALE
Tabellenvorletzter	MALE
Tablette	MALE
Tablettencocktail	MALE
Tabu	MALE
Tanzmusik	FEMALE
Tanzorgie	FEMALE
Tanztheater	FEMALE
Taoismus	FEMALE
Tatsache	FEMALE
Tatverdacht	FEMALE
Tatverdächtig	FEMALE
Tatwaffe	FEMALE
Tatzeit	FEMALE
Tau	FEMALE
Tauchunterricht	MALE
Tauchurlaub	MALE
Tauchzentrum	MALE
Tauglichkeit	MALE
Taunusbahn	MALE
Taunusklub	MALE
Tauschangebot	MALE
Tauschbörse	MALE
Tauschmarkt	MALE
Tauschprogramm	MALE
Tauschtag	MALE
Tauschwert	MALE
Tausend-	MALE
Tausende	MALE
Tausendstel	MALE
Tauwetter	MALE
Tauziehen	MALE
Taverne	MALE
Tee	MALE
Teebeutel-	MALE
Teeflasche	MALE
Teelöffel	MALE
Teenager	MALE
Teenageralter	MALE
Teig	MALE
Teigsäuerung	MALE
Teil	MALE
Teilaspekt	MALE
Teilbereich	MALE
Teilbetriebsergebnis	MALE
Teilchen	MALE
Teilelieferung	MALE
Teilergebnis	MALE
Teilewerk	MALE
Teilgeständnis	MALE
Teilhaber	MALE
Teilkonzern	MALE
Teilnahme	MALE
Teilnahmebedingung	MALE
Teilnahmebestätigung	MALE
Teilnahmegebühr	MALE
Teilnahmevoraussetzung	MALE
Teilnehmer	MALE
Teilnehmerin	MALE
Teilnehmerkreis	MALE
Teilnehmerstaat	MALE
Teilnehmerzahl	MALE
Teilprivatisierung	MALE
Teilstreitkraft	MALE
Teilstück	MALE
Teilsystem	MALE
Teilung	MALE
Teilzeit	FEMALE
Teilzeitarbeit	FEMALE
Teilzeitarbeitsregelung	FEMALE
Teilzeitbeschäftigung	FEMALE
Teilzeitkraft	FEMALE
Teilzeitstelle	FEMALE
Tel	FEMALE
Telearbeit	FEMALE
Thematik	FEMALE
Thematisierung	FEMALE
Themenabend	FEMALE
Themenausschuß	FEMALE
Themenbereich	FEMALE
Themenbündel	FEMALE
Themenfeld	FEMALE
Themengebiet	FEMALE
Themenkomplex	FEMALE
Themenkreis	FEMALE
Themenschwerpunkt	FEMALE
Themenspektrum	FEMALE
Themenstarter	FEMALE
Themenstellung	FEMALE
Thymian	MALE
Tinktur	FEMALE
Tinnitus	FEMALE
Tinte	FEMALE
Tintendrucker	FEMALE
Tintenkleckser	FEMALE
Tintenpatrone	FEMALE
Tintenspucker	FEMALE
Tintenstrahldrucker	FEMALE
Tintenstrahler	FEMALE
Tintentank	FEMALE
Tintentropfen	FEMALE
Tintenverbrauch	FEMALE
Tintenvorrat	FEMALE
Tip	MALE
Tipp	MALE
Tipp	MALE
Tirade	MALE
Tischwein	MALE
Tok_type_digit_slash	MALE
Tok_type_noun	MALE
Tok_type_number_percent	MALE
Toleranz	FEMALE
Tolerierung	FEMALE
Tolerierungsmodell	FEMALE
Torf	MALE
Torfrau	MALE
Torhaus	MALE
Torheit	MALE
Torhüter	MALE
Torte	FEMALE
Tortur	FEMALE
Torwandschiessen	FEMALE
Torwandtreffer	FEMALE
Torwart	FEMALE
Tragik	FEMALE
Tragkraftspritze	FEMALE
Traglufthalle	FEMALE
Tragweite	FEMALE
Tragödie	FEMALE
Trailer	FEMALE
Traumurlaub	MALE
Traumwelt	MALE
Traumziel	MALE
Trekking-	MALE
Trekkingmöglichkeit	MALE
Trekkingtour	MALE
Truhe	MALE
Trümmer	MALE
Tuberkulose	FEMALE
Tuch	FEMALE
Tuchfabrik	FEMALE
Tuchlappen	FEMALE
Tucholsky-	FEMALE
Typhus	MALE
Typisierung	MALE
Typologie	MALE
Typus	MALE
Tyrann	MALE
Tyrannei	MALE
UEFA-	FEMALE
UEFA-	FEMALE
UEFA-	FEMALE
UEFA-	FEMALE
UN-	MALE
URL	MALE
US-	FEMALE
US-	FEMALE
US-	FEMALE
US-	FEMALE
US-	FEMALE
US-	FEMALE
US-	FEMALE
US-	MALE
US-	MALE
US-	MALE
US-	MALE
US-	MALE
US-	MALE
US-	MALE
US-	MALE
US-	MALE
US-	MALE
US-	MALE
US-	MALE
US-	MALE
US-	MALE
US-	MALE
USA-	MALE
Umlaut	MALE
Umlaut	MALE
Umorientierungsprozeß	MALE
Umrechnung	MALE
Umrechnungskurs	MALE
Umrüstung	MALE
Umsatz	MALE
Umsatzeinbuße	MALE
Umsatzgarant	MALE
Umsatzrendite	MALE
Umsatzrückgang	MALE
Umsatzschwankung	MALE
Umsatzsteigerung	MALE
Umsatzsteuer	MALE
Umsatzverlust	MALE
Umsatzvolumen	MALE
Umsatzwachstum	MALE
Umsatzzahl	MALE
Umsatzzunahme	MALE
Umschichtung	MALE
Umschlag	MALE
Umschließung	MALE
Umschreibung	MALE
Umschuldung	MALE
Umschuldungsabkommen	MALE
Umschuldungsverhandlung	MALE
Umschulungsmassnahme	MALE
Umschwung	MALE
Umsetzung	MALE
Umsiedelung	MALE
Umspannwerk	MALE
Umstand	MALE
Umstand	MALE
Umsteigen	MALE
Umstellsatz	MALE
Umstellung	MALE
Umstellungsprozeß	MALE
Umstrukturierung	MALE
Umstrukturierungsplan	MALE
Umsturzplan	MALE
Umtrunk	MALE
Umverteilung	MALE
Umverteilungsaufwand	MALE
Umverteilungsbemühung	MALE
Umverteilungsideologie	MALE
Umverteilungssystem	MALE
Umwandlung	MALE
Umwandlungsplan	MALE
Umweg	MALE
Umwegfinanzierung	MALE
Umwelt	MALE
Umwelt-	MALE
Umweltabkommen	MALE
Umweltaktivist	MALE
Umweltaktivisten	MALE
Umweltamt	MALE
Umweltangst	MALE
Umweltantrag	MALE
Umweltaspekt	MALE
Umweltausschuss	MALE
Umweltauswirkung	MALE
Umweltbedingung	MALE
Umweltbehörde	MALE
Umweltbelastung	MALE
Umweltbereich	MALE
Umweltbildung	MALE
Umweltbundesamt	MALE
Umweltdezernent	MALE
Umwelteigenschaft	MALE
Umwelteinfluss	MALE
Umweltengagement	MALE
Umweltentlastung	MALE
Umwelterklärung	MALE
Umwelterziehung	MALE
Umweltfaktor	MALE
Umweltfibel	MALE
Umweltfirma	MALE
Umweltfolge	MALE
Umweltforscher	MALE
Umweltforschung	MALE
Umweltfrage	MALE
Umweltgefährdung	MALE
Umweltgesetz	MALE
Umweltgesichtspunkt	MALE
Umweltgift	MALE
Umweltgipfel	MALE
Umweltgrund	MALE
Umweltgruppe	MALE
Umweltkatastrophe	MALE
Umweltkonferenz	MALE
Umweltmanagement	MALE
Umweltminister	MALE
Umweltministerin	MALE
Umweltministerium	MALE
Umweltorganisation	MALE
Umweltpolitik	MALE
Umweltpreis	MALE
Umweltproblematik	MALE
Umweltprogramm	MALE
Umweltprojekte	MALE
Umweltrecht	MALE
Umweltreferent	MALE
Umweltressort	MALE
Umweltschaden	MALE
Umweltschutz	MALE
Umweltschutz-	MALE
Umweltschutzauflage	MALE
Umweltschutzauflage	MALE
Umweltschutzgesetz	MALE
Umweltschutzmarkt	MALE
Umweltschutzorganisation	MALE
Umweltschutzverband	MALE
Umweltschutzvorgabe	MALE
Umweltseminar	MALE
Umweltsiegel	MALE
Umweltsparte	MALE
Umweltstandard	MALE
Umweltsteuer	MALE
Umweltstraftat	MALE
Umweltsymbol	MALE
Umwelttechnik	MALE
Umwelttechnologie	MALE
Umweltthema	MALE
Umweltverband	MALE
Umweltverbrauch	MALE
Umweltverschmutzer	MALE
Umweltverschmutzung	MALE
Umweltverträglichkeit	MALE
Umweltverträglichkeitsprüfung	MALE
Umweltveränderung	MALE
Umweltzerstörung	MALE
Umwidmung	MALE
Umwidmungskonzept	MALE
Umwälzung	MALE
Umzug	MALE
Umzugsgeld	MALE
Umzugskosten	MALE
Umzugstermin	MALE
Unkenntlichkeit	MALE
Unterhaltungsmusik	FEMALE
Unterhaltungspflichtig	FEMALE
Unterhaltungsprogramm	FEMALE
Unterhaltungswert	FEMALE
Unterhaltungszentrum	FEMALE
Unterhausmehrheit	FEMALE
Unterhauswahl	FEMALE
Unterhöhlung	FEMALE
Unterjochung	FEMALE
Unterkunft	FEMALE
Unterkunftmöglichkeit	FEMALE
Unterkunftsmöglichkeit	FEMALE
Unterkunftsverzeichnis	FEMALE
Unterlage	FEMALE
Unterlassung	FEMALE
Unterlassungsanspruch	FEMALE
Unterlassungserklärung	FEMALE
Untermalung	FEMALE
Unternehmen	FEMALE
Unternehmensanwendung	FEMALE
Unternehmensberater	FEMALE
Unternehmensberatung	FEMALE
Unternehmensberatungsgesellschaft	FEMALE
Unternehmensberatungshaus	FEMALE
Unternehmensbereich	FEMALE
Unternehmensbewertung	FEMALE
Unternehmenseinheit	FEMALE
Unternehmenserfolg	FEMALE
Unternehmensergebnis	FEMALE
Unternehmensführung	FEMALE
Unternehmensgeschichte	FEMALE
Unternehmensgewinn	FEMALE
Unternehmensgruppe	FEMALE
Unternehmensgründung	FEMALE
Unternehmensidentität	FEMALE
Unternehmenskette	FEMALE
Unternehmenskommunikation	FEMALE
Unternehmenskonglomerat	FEMALE
Unternehmenskonzept	FEMALE
Unternehmenskreis	FEMALE
Unternehmenskultur	FEMALE
Unternehmensleitung	FEMALE
Unternehmensnachfolge	FEMALE
Unternehmensnetzwerk	FEMALE
Unternehmensphilosophie	FEMALE
Unternehmenspitze	FEMALE
Unternehmenspolitik	FEMALE
Unternehmensreform	FEMALE
Unternehmensspitze	FEMALE
Unternehmenssprecher	FEMALE
Unternehmenssteuer	FEMALE
Unternehmenssteuerreform	FEMALE
Unternehmensstrategie	FEMALE
Unternehmensstruktur	FEMALE
Unternehmensteil	FEMALE
Unternehmensteuerreform	FEMALE
Unternehmensvermögen	FEMALE
Unternehmensversichert	FEMALE
Unternehmenszahl	FEMALE
Unternehmensziel	FEMALE
Unternehmer	FEMALE
Unternehmer-	FEMALE
Unternehmereinkünfte	FEMALE
Unternehmergeist	FEMALE
Unternehmerin	FEMALE
Unternehmerkollege	FEMALE
Unternehmertum	FEMALE
Unternehmerverband	FEMALE
Unternehmung	FEMALE
Unternehnmerverband	FEMALE
Unterordnung	FEMALE
Unterredung	FEMALE
Unterricht	MALE
Unterrichtseinheit	MALE
Unterrichtsfach	MALE
Unterrichtsmaterial	MALE
Unterrichtsrhythmus	MALE
Unterrichtsstunde	MALE
Unterrichtszeit	FEMALE
Untersagung	FEMALE
Unterscheidung	FEMALE
Unterscheidungsmerkmal	FEMALE
Unterschenkel	FEMALE
Unterschicht	FEMALE
Unterschied	FEMALE
Unterschiedlichkeit	FEMALE
Unterschlagung	FEMALE
Unterschlagungsvorwurf	FEMALE
Unterschlupf	FEMALE
Unterschreidungskraft	FEMALE
Unterschreitung	FEMALE
Unterschrift	FEMALE
Unterschriftenaktion	FEMALE
Unterschriftenliste	FEMALE
Unterschriftensammlung	FEMALE
Unterseite	FEMALE
Untersicht	FEMALE
Unterstaatssekretär	FEMALE
Unterstellen	FEMALE
Unterstellt	FEMALE
Unterstellung	FEMALE
Unterstufenchor	FEMALE
Unterstützergruppe	FEMALE
Unterstützung	FEMALE
Unterstützungsaufgabe	FEMALE
Untersuchung	FEMALE
Untersuchungsausschuss	FEMALE
Untersuchungsbehörde	FEMALE
Untersuchungsergebnis	FEMALE
Untersuchungsgefängnis	FEMALE
Untersuchungsgegenstand	FEMALE
Untersuchungshaft	FEMALE
Untersuchungshäftling	FEMALE
Untersuchungskatalog	FEMALE
Untersuchungskommission	FEMALE
Untersuchungsmethode	FEMALE
Untersuchungsmöglichkeit	FEMALE
Untersuchungsrichter	FEMALE
Untertan	FEMALE
Unterteil	FEMALE
Unterteilung	FEMALE
Untertreibung	FEMALE
Untertunnelung	FEMALE
Urin	MALE
Urinmanipulation	MALE
Urknall	MALE
Urkunde	MALE
Urkundenfälschung	MALE
Urkundsbeamtin	MALE
Urlaub	MALE
Urlauber	MALE
Urlaubsangebot	MALE
Urlaubsanspruch	MALE
Urlaubsbeschäftigung	MALE
Urlaubserinnerung	MALE
Urlaubsgebiet	MALE
Urlaubsgeld	MALE
Urlaubsgeschäft	MALE
Urlaubsimpression	MALE
Urlaubskurs	MALE
Urlaubsland	MALE
Urlaubsliste	MALE
Urlaubsmonat	MALE
Urlaubsmöglichkeit	MALE
Urlaubsort	MALE
Urlaubsort-	MALE
Urlaubspauschalreise	MALE
Urlaubsplanung	MALE
Urlaubsproblem	MALE
Urlaubsqualität	MALE
Urlaubsreise	MALE
Urlaubsriese	MALE
Urlaubssaison	MALE
Urlaubstag	MALE
Urlaubswoche	MALE
Urlaubszeit	FEMALE
Urlaubsziel	FEMALE
Urlaubtag	FEMALE
Urne	FEMALE
Urnengang	FEMALE
Urologe	FEMALE
Urologie	FEMALE
Urzeit	FEMALE
Us-	FEMALE
Us-	FEMALE
Us-	FEMALE
Us-	FEMALE
Us-	MALE
Us-	MALE
Us-	MALE
Us-	MALE
Us-	MALE
Us-	MALE
Us-	MALE
Us-	MALE
Us-	MALE
Us-	MALE
Us-	MALE
Us-	MALE
Us-	MALE
Us-	MALE
Us-	MALE
Us-	MALE
Vanillezucker	MALE
Verbannung	FEMALE
Verbesserung	FEMALE
Verbesserungsprogramm	FEMALE
Verbesserungsvorschlag	FEMALE
Verbilligung	FEMALE
Verbindlichkeit	FEMALE
Verbindung	FEMALE
Verbindungkabel	FEMALE
Verbindungsaufbau	FEMALE
Verbindungsdatum	FEMALE
Verbindungshaus	FEMALE
Verbindungsrohr	FEMALE
Verbindungsstrasse	FEMALE
Verbindungstür	FEMALE
Verbitterung	FEMALE
Verblenung	FEMALE
Verblüffung	FEMALE
Verbot	FEMALE
Verbotsdrohung	FEMALE
Verbrauch	FEMALE
Verbraucher	FEMALE
Verbraucher-	FEMALE
Verbraucheraufklärung	FEMALE
Verbraucherberatung	FEMALE
Verbraucherfrage	FEMALE
Verbrauchergewohnheit	FEMALE
Verbrauchergruppe	FEMALE
Verbraucherin	FEMALE
Verbraucherkreis	FEMALE
Verbrauchermarkt	FEMALE
Verbraucherpreis	FEMALE
Verbraucherschutz	FEMALE
Verbraucherschutzverein	FEMALE
Verbraucherschützer	FEMALE
Verbraucherverband	FEMALE
Verbraucherverhalten	FEMALE
Verbraucherzentrale	FEMALE
Verbrauchsmaterial	FEMALE
Verbrauchssteuer	FEMALE
Verbrauchsteuer	FEMALE
Verbrechen	FEMALE
Verbrechensbekämpfung	FEMALE
Verbrecher	FEMALE
Verbreitung	FEMALE
Verbreitungsgebiet	FEMALE
Verbrennung	FEMALE
Verbrennungsanlagen	FEMALE
Verbrennungsluft	FEMALE
Verbrennungsprozeß	FEMALE
Verbrüderung	FEMALE
Verbund	FEMALE
Verbundenheit	FEMALE
Verbundnetz	FEMALE
Verbundprojekt	FEMALE
Verbundraum	FEMALE
Verbundunternehmen	FEMALE
Verbundvorhaben	FEMALE
Verfärbung	FEMALE
Verfügungsgewalt	FEMALE
Verführung	FEMALE
Vergabe	FEMALE
Vergabeverfahren	FEMALE
Vergabevolumen	FEMALE
Vergangen	FEMALE
Vergangenheit	FEMALE
Vergangenheitsaufarbeitung	FEMALE
Vergangenheitsbewältigung	FEMALE
Vergasung	FEMALE
Vergebung	FEMALE
Vergehen	FEMALE
Vergeltung	FEMALE
Vergeltungsaktion	FEMALE
Vergemeinschaftung	FEMALE
Vergesellschaftung	FEMALE
Vergessenheit	FEMALE
Vergesslichkeit	FEMALE
Vergeudung	FEMALE
Vergewaltigung	FEMALE
Vergewaltigungsprozeß	FEMALE
Vergewisserung	FEMALE
Vergeßlichkeit	FEMALE
Vergiftung	FEMALE
Vergleich	FEMALE
Vergleichbarkeit	FEMALE
Vergleichsangebot	FEMALE
Vergleichsantrag	FEMALE
Vergleichsbild	FEMALE
Vergleichsmietensystem	FEMALE
Vergleichsordnung	FEMALE
Vergleichsperiode	FEMALE
Vergleichsverfahren	FEMALE
Vergleichsverwalter	FEMALE
Vergleichswert	FEMALE
Vergleichszahl	FEMALE
Vergleichszeitraum	FEMALE
Vergnügen	FEMALE
Vergnügung	FEMALE
Vergnügungspark	FEMALE
Vergrößerung	FEMALE
Vergänglichkeit	FEMALE
Vergünstigung	FEMALE
Vergütung	FEMALE
Vergütungsanspruch	FEMALE
Vergütungsgruppe	FEMALE
Verhaftung	FEMALE
Verhalten	FEMALE
Verhaltensauffälligkeit	FEMALE
Verhaltenskodex	FEMALE
Verhaltensmuster	FEMALE
Verhaltensregel	FEMALE
Verhaltensstörung	FEMALE
Verhaltenstherapie	FEMALE
Verhaltensweise	FEMALE
Verhaltensweise	FEMALE
Verhaltensänderung	FEMALE
Verhandlung	FEMALE
Verhandlungsergebnis	FEMALE
Verhandlungsführer	FEMALE
Verhandlungskommission	FEMALE
Verhandlungsleiter	FEMALE
Verhandlungslinie	FEMALE
Verhandlungslösung	FEMALE
Verhandlungsmandat	FEMALE
Verhandlungspartner	FEMALE
Verhandlungsposition	FEMALE
Verhandlungsrecht	FEMALE
Verhandlungsrunde	FEMALE
Verhandlungsstand	FEMALE
Verhandlungstag	FEMALE
Verhandlungsteilnehmer	FEMALE
Verhandlungstisch	FEMALE
Verhandlungsunfähigkeit	FEMALE
Verharmlosung	FEMALE
Verheißung	FEMALE
Verherrlichung	FEMALE
Verhältnis	FEMALE
Verhältnismäßigkeit	FEMALE
Vermerk	MALE
Vermessung	MALE
Vermieter	MALE
Vermieterin	MALE
Vermietung	MALE
Verminderung	MALE
Vermischung	MALE
Vermittler	MALE
Vermittlerorganisation	MALE
Vermittlung	MALE
Vermittlungsausschuss	MALE
Vermittlungsausschuß	MALE
Vermittlungsbemühung	MALE
Vermittlungsgesellschaft	MALE
Vermittlungsstation	MALE
Vermittlungsstelle	MALE
Vermittlungstechnik	MALE
Vermittlungsverfahren	MALE
Vermittlungsvorschlag	MALE
Vermutung	FEMALE
Vermutung	MALE
Vermächtnis	FEMALE
Vermögen	MALE
Vermögensanteil	FEMALE
Vermögensbildung	FEMALE
Vermögensbildungsansatz	FEMALE
Vermögenserklärung	FEMALE
Vermögensgegenstand	FEMALE
Vermögensschaden	MALE
Vermögenssteuer	MALE
Vermögensteuer	FEMALE
Vermögenstrennung	FEMALE
Vermögensverhältnis	FEMALE
Vermögensverwaltung	MALE
Vermögensverwaltungs-	MALE
Vermögensverwaltungs-	MALE
Vermögenswert	FEMALE
Vernachlässigung	FEMALE
Vernehmen	FEMALE
Vernehmung	FEMALE
Verneinung	FEMALE
Vernetzung	FEMALE
Vernichtung	FEMALE
Vernichtungskrieg	FEMALE
Vernichtungslager	FEMALE
Verniedlichung	FEMALE
Vernissage	FEMALE
Verona	MALE
Verordnung	MALE
Verordnungsblatt	MALE
Verordnungsgeber	MALE
Verortung	MALE
Verpachtung	MALE
Verpackung	MALE
Verpackungsanlage	MALE
Verpackungshersteller	MALE
Verpackungskonzern	MALE
Verpackungskünstler	MALE
Verpackungsmaschinenhersteller	MALE
Verpackungsverordnung	MALE
Verpflanzung	MALE
Verpflegung	FEMALE
Verpflegungsart	FEMALE
Verpflegungsleistung	FEMALE
Verpflegungspaket	FEMALE
Verpflichtung	FEMALE
Verpflichtungsermächtigung	FEMALE
Verquickung	FEMALE
Verrechnung	FEMALE
Verrichtung	FEMALE
Verriegelung	FEMALE
Verringerung	FEMALE
Verruf	FEMALE
Verrückt	FEMALE
Vers	FEMALE
Versachlichung	FEMALE
Versagen	FEMALE
Versagung	FEMALE
Versammlung	FEMALE
Versammlungsfreiheit	FEMALE
Versammlungsleiter	FEMALE
Versammlungsverlauf	FEMALE
Versand	FEMALE
Versandhandel	FEMALE
Versandhaus	FEMALE
Versandkoste	FEMALE
Versanstaltung	FEMALE
Verschicken	FEMALE
Verschieben	FEMALE
Verschiebung	FEMALE
Verschiedenartigkeit	FEMALE
Verschiedenheit	FEMALE
Verschiffung	FEMALE
Verschlechterung	FEMALE
Verschleierung	FEMALE
Verschleiß	FEMALE
Verschleppung	FEMALE
Verschleuderung	FEMALE
Verschluss	FEMALE
Verschluß	FEMALE
Verschlüsselung	FEMALE
Verschmelzung	FEMALE
Verschmutzer	FEMALE
Verschmutzung	FEMALE
Verschmutzungsverursacher	FEMALE
Verschnaufpause	FEMALE
Verschraubung	FEMALE
Verschreibung	FEMALE
Verschreibungsempfehlung	FEMALE
Verschrottung	FEMALE
Verschränkung	FEMALE
Verschuldung	FEMALE
Verschuldungsgrenze	FEMALE
Verschwelung	FEMALE
Verschwendung	FEMALE
Verschwiegenheit	FEMALE
Verschwindenlassen	FEMALE
Verschwisterung	FEMALE
Verschwörung	FEMALE
Verschwörungstheorie	FEMALE
Verschärfung	FEMALE
Verschönerung	FEMALE
Versehen	FEMALE
Verselbständigung	FEMALE
Versendung	FEMALE
Versenkung	FEMALE
Versenkungsplan	FEMALE
Versetzung	FEMALE
Verseuchung	FEMALE
Versicherer	FEMALE
Versichert	FEMALE
Versichertenvertreter	FEMALE
Versicherung	FEMALE
Versicherungs-	FEMALE
Versicherungs-	FEMALE
Versicherungs-	FEMALE
Versicherungsableger	FEMALE
Versicherungsaktie	FEMALE
Versicherungsbedingung	FEMALE
Versicherungsfall	FEMALE
Versicherungsfreiheit	FEMALE
Versicherungsgeschäft	FEMALE
Versicherungsgesellschaft	FEMALE
Versicherungsgewerbe	FEMALE
Versicherungsgruppe	FEMALE
Versicherungskonzern	FEMALE
Versicherungsmarkt	FEMALE
Versicherungsnehmer	FEMALE
Versicherungspaket	FEMALE
Versicherungspartner	FEMALE
Versicherungspflicht	FEMALE
Versicherungspolice	FEMALE
Versicherungsschaden	FEMALE
Versicherungsschutz	FEMALE
Versicherungssumme	FEMALE
Versicherungsträger	FEMALE
Versicherungsunternehmen	FEMALE
Versicherungsunternehmer	FEMALE
Versicherungsverbund	FEMALE
Versicherungsvertrag	FEMALE
Versicherungsvertreter	FEMALE
Versicherungswesen	FEMALE
Versicherungswirtschaft	FEMALE
Versicherungsältester	FEMALE
Versiegelung	FEMALE
Version	FEMALE
Versklavung	FEMALE
Versorgung	FEMALE
Versorgungsanspruch	FEMALE
Versorgungsauftrag	FEMALE
Versorgungsausgabe	FEMALE
Versorgungsausgleich	FEMALE
Versorgungsbezug	FEMALE
Versorgungsgebiet	FEMALE
Versorgungskonzern	FEMALE
Versorgungsleistung	FEMALE
Versorgungsmangel	FEMALE
Versorgungsrecht	FEMALE
Versorgungssicherheit	FEMALE
Versorgungsstand	FEMALE
Versorgungsstation	FEMALE
Versorgungsunternehmen	FEMALE
Versorgungsvollmacht	FEMALE
Versorgungszentrum	FEMALE
Verspottung	FEMALE
Versprechung	FEMALE
Verspätung	FEMALE
Verstaatlichung	FEMALE
Verstaatlichungsprogramm	FEMALE
Verständigung	FEMALE
Verständlichkeit	FEMALE
Verständnis	FEMALE
Versäumnis	FEMALE
Versäumnisurteil	FEMALE
Versäumung	FEMALE
Versöhnung	FEMALE
Virtuosität	FEMALE
Virus	FEMALE
Viruskrankheit	FEMALE
Visa	FEMALE
Visa-	FEMALE
Voraussetzung	FEMALE
Voraussicht	FEMALE
Vorauszahlung	FEMALE
Vorbehalt	MALE
Vorbehaltserklärung	MALE
Vorbereiten	MALE
Vorbereitung	MALE
Vorbereitungsdienst	MALE
Vorbereitungsgespräch	MALE
Vorbereitungskonferenz	MALE
Vorbereitungsphase	MALE
Vorbereitungstermin	MALE
Vorbereitungstreff	MALE
Vorbereitungstreffen	MALE
Vorbereitungszeit	FEMALE
Vorbesprechung	FEMALE
Vorbesprechungstermin	FEMALE
Vorbestellung	FEMALE
Vorbeugung	FEMALE
Vorbild	FEMALE
Vorbildfunktion	FEMALE
Vorbote	FEMALE
Vordenker	FEMALE
Vordergrund	FEMALE
Vordermann	FEMALE
Vorderseite	FEMALE
Vordersitz	FEMALE
Voreingenommenheit	FEMALE
Vorentscheidung	FEMALE
Vorerfahrung	FEMALE
Vorfahrt	FEMALE
Vorfall	FEMALE
Vorfeld	FEMALE
Vorfertigungsbetrieb	FEMALE
Vorführung	FEMALE
Vorgabe	FEMALE
Vorgang	FEMALE
Vorgangsart	FEMALE
Vorgarten	FEMALE
Vorgehen	FEMALE
Vorgehensweise	FEMALE
Vorgeschmack	FEMALE
Vorgesetzte	FEMALE
Vorgänger	FEMALE
Vorgängerexemplar	FEMALE
Vorgängerin	FEMALE
Vorgängerpartei	FEMALE
Vorgängerregierung	FEMALE
Vorhaben	FEMALE
Vorhanden	FEMALE
Vorhandensein	FEMALE
Vorhang	FEMALE
Vorjahr	FEMALE
Vorjahresertrag	FEMALE
Vorjahresmeister	FEMALE
Vorjahresmonat	FEMALE
Vorjahresniveau	FEMALE
Vorjahressieger	FEMALE
Vorjahresstand	FEMALE
Vorjahreszeitraum	FEMALE
Vorkaufsrecht	FEMALE
Vorkehrung	FEMALE
Vorkommen	FEMALE
Vorkommnis	FEMALE
Vorkämpfer	FEMALE
Vorlage	FEMALE
Vorlauf	FEMALE
Vorlaufkosten	FEMALE
Vorlaufzeit	FEMALE
Vorleistung	FEMALE
Vorlesung	FEMALE
Vorlesungsboykott	FEMALE
Vorlesungsstreik	FEMALE
Vorlesungsverzeichnis	FEMALE
Vorlesungszeit	FEMALE
Vorliebe	FEMALE
Vorliegen	FEMALE
Vorläufer	FEMALE
Vorläufigkeit	FEMALE
Vormauerung	FEMALE
Vormerkung	FEMALE
Vormittags-	FEMALE
Vormittagstermin	FEMALE
Vormundschaft	FEMALE
Vormundschaftsgericht	FEMALE
Vornahme	FEMALE
Vorname	FEMALE
Vorstellung	FEMALE
Vorstellungsgespräch	FEMALE
Vorstellungskraft	FEMALE
Vorsteuerbetrag	FEMALE
Vorsteuergewinn	FEMALE
Vorstoß	FEMALE
Vorstrafe	FEMALE
Vorstudie	FEMALE
Vorstufe	FEMALE
Vortag	FEMALE
Vorteil	FEMALE
Vorteil	MALE
Vortrag	MALE
Vortragsabend	MALE
Vortragsreihe	MALE
Vortreffen	MALE
Vortritt	MALE
Voruntersuchung	MALE
Vorurteil	MALE
Vorurteilslosigkeit	MALE
Vorverkaufsrecht	MALE
Vorverurteilung	MALE
Vorwahlspektakel	MALE
Vorweihnachtszeit	MALE
Vorwurf	MALE
Vorwurf	MALE
Vorzeichen	MALE
Vorzeige-	MALE
Vorzeigeexemplar	MALE
Vorzeigekonzern	MALE
Vorzeigewagen	MALE
Vorzimmer	MALE
Vorzug	MALE
Vorzugsaktie	MALE
Vorzugspreis	MALE
Waffengewalt	FEMALE
Waffengleichheit	FEMALE
Waffenhandel	FEMALE
Waffenhändler	FEMALE
Waffenkäufer	FEMALE
Waffenlager	FEMALE
Waffenlieferung	FEMALE
Waffenprogramm	FEMALE
Waffenrecht	FEMALE
Wartungsarbeit	FEMALE
Warze	FEMALE
Waschbecken	FEMALE
Waschmaschine	FEMALE
Waschmittel	FEMALE
Waschpulver	FEMALE
Waschraum	FEMALE
Waschstrassenbesuch	FEMALE
Waschstraßendurchgang	FEMALE
Wasserdampf	MALE
Wasserenthärter	MALE
Wasserentnahme	MALE
Wasserfabrik	MALE
Wasserfahrrad	MALE
Wasserfall	MALE
Wasserflugzeug	MALE
Wasserfläche	MALE
Wassergott	MALE
Wasserhahn	MALE
Wasserhaushalt	MALE
Wasserkraft	MALE
Wasserkuppe	MALE
Wasserlandschaft	MALE
Wasserlauf	MALE
Wasserleitung	MALE
Wasserlieferung	MALE
Wasserlinie	MALE
Wassermangel	MALE
Wassermann	MALE
Wassermasse	MALE
Wassermenge	MALE
Wassermotorradfahren	MALE
Wassermusik	MALE
Wassernotstand	MALE
Wasseroberfläche	MALE
Wasserpistole	MALE
Wasserpolitik	MALE
Wasserproblem	MALE
Wasserqualität	MALE
Wasserratte	MALE
Wasserrichtlinie	MALE
Wasserrutschbahn	MALE
Wasserscheide	MALE
Wasserski	MALE
Wasserski-	MALE
Wasserskifahren	MALE
Wasserskilaufen	MALE
Wassersparen	MALE
Wassersport	MALE
Wassersportart	MALE
Wassersportler	MALE
Wassersporturlaub	MALE
Wasserspülung	MALE
Wasserstand	MALE
Wasserstelle	MALE
Wasserstoff	MALE
Wasserstoffatom	MALE
Wasserstraße	MALE
Wassertemperatur	MALE
Wassertiefe	MALE
Wasserverbrauch	MALE
Wasserverbraucher	MALE
Wasserverlust	MALE
Wasserverschmutzung	MALE
Wasserversorgung	MALE
Wasserversorgungsunternehmen	MALE
Wasservogel	MALE
Wasservorrat	MALE
Wasserwechsel	MALE
Wasserwerfer	MALE
Wasserwerk	MALE
Wasserwert	MALE
Wasserwirtschaft	MALE
Wasserzeichen	MALE
Wein	MALE
Weinausflug	MALE
Weisung	MALE
Weitblick	MALE
Weite	MALE
Weiterbildner	MALE
Weiterbildung	MALE
Weiterbildungsangebot	MALE
Weiterbildungsgesetz	MALE
Weiterbildungsmaßnahme	MALE
Weiterentwicklung	MALE
Weiterexistenz	MALE
Weiterfahrt	MALE
Weitsicht	MALE
Weitsichtigkeit	MALE
Weitsprung	MALE
Weizen	MALE
Weißwein	MALE
Wind	MALE
Windel	MALE
Windenergie	MALE
Windenergieanlage	MALE
Wochenarbeitszeit	FEMALE
Wochenbeginn	FEMALE
Wochenbericht	FEMALE
Wochenend-	FEMALE
Wochenend-	FEMALE
Wochenend-	FEMALE
Wochenend-	FEMALE
Wochenend-	FEMALE
Wochenendangebot	FEMALE
Wochenende	FEMALE
Wochenendheimfahrer	FEMALE
Wochenendreise	FEMALE
Wochenendseminar	FEMALE
Wochenendtag	FEMALE
Wochenendtermin	FEMALE
Wochenendtrip	FEMALE
Wochenhälfte	FEMALE
Wochenkalender	FEMALE
Wochenmagazin	FEMALE
Wochenmarkt	FEMALE
Wochenmitte	FEMALE
Wochenplan	FEMALE
Wochenplanung	FEMALE
Wochenplanungssitzung	FEMALE
Wochenrhythmus	FEMALE
Wochenschluß	FEMALE
Wochenschrift	FEMALE
Wochenseminar	FEMALE
Wochenstunde	FEMALE
Wochenstundenplan	FEMALE
Wochentag	FEMALE
Wochenteil	FEMALE
Wochenvignette	FEMALE
Wochenzeitschrift	FEMALE
Wochenzeitung	FEMALE
Wodka	MALE
Wurst	FEMALE
Wurstboutique	FEMALE
Wurstigkeit	FEMALE
Wurstzipfel	FEMALE
Wurzel	FEMALE
Wöhlerschule	MALE
Wöhlerschüler	MALE
Wölbung	MALE
Zeit	FEMALE
Zeit	FEMALE
Zeitablauf	FEMALE
Zeitabschnitt	FEMALE
Zeitabstand	FEMALE
Zeitalter	FEMALE
Zeitangebot	FEMALE
Zeitanteil	FEMALE
Zeitarbeit	FEMALE
Zeitaufwand	FEMALE
Zeitbombe	FEMALE
Zeitdauer	FEMALE
Zeitdilation	FEMALE
Zeitdruck	FEMALE
Zeiteinteilung	FEMALE
Zeitempfinden	FEMALE
Zeitersparnis	FEMALE
Zeitfenster	FEMALE
Zeitfrage	FEMALE
Zeitgeist	FEMALE
Zeitgenosse	FEMALE
Zeitgenossenschaft	FEMALE
Zeitgeschehen	FEMALE
Zeitgeschichte	FEMALE
Zeitgestaltung	FEMALE
Zeitgewinn	FEMALE
Zeitgrund	FEMALE
Zeitlang	FEMALE
Zeitlupe	FEMALE
Zeitmanagement	FEMALE
Zeitnot	FEMALE
Zeitplan	FEMALE
Zeitpunkt	FEMALE
Zeitraffer	FEMALE
Zeitrahmen	FEMALE
Zeitraum	FEMALE
Zeitrechnung	FEMALE
Zeitreise	FEMALE
Zeitreserve	FEMALE
Zeitschrift	FEMALE
Zeitschriften-	FEMALE
Zeitschriftenhandel	FEMALE
Zeitschriftenmarkt	FEMALE
Zeitsouveränität	FEMALE
Zeitspanne	FEMALE
Zeittafel	FEMALE
Zeittermin	FEMALE
Zeitumstellung	FEMALE
Zeitung	FEMALE
Zeitungsanzeige	FEMALE
Zeitungsartikel	FEMALE
Zeitungsausschnitt	FEMALE
Zeitungsbericht	FEMALE
Zeitungsgruppe	FEMALE
Zeitungskiosk	FEMALE
Zeitungsladen	FEMALE
Zeitungslayout	FEMALE
Zeitungsmarkt	FEMALE
Zeitungspapier	FEMALE
Zeitungsverkäufer	FEMALE
Zeitunterschied	FEMALE
Zeitverlust	FEMALE
Zeitverschiebung	FEMALE
Zeitvertreib	FEMALE
Zeitverzögerung	FEMALE
Zeitvolumen	FEMALE
Zeitvorgabe	FEMALE
Zeitvorschlag	FEMALE
Zeitwende	FEMALE
Zement	MALE
Zementhersteller	MALE
Zimt	MALE
Zitronensaft	MALE
Zitronenschale	MALE
Zubereitungszeit	FEMALE
Zubringer	FEMALE
Zubringerbus	FEMALE
Zuccini	FEMALE
Zucht	FEMALE
Zuchthaus	FEMALE
Zuchtleistung	FEMALE
Zuchtrind	FEMALE
Zucker	MALE
Zuckerarbeiter	MALE
Zuckerbarone	MALE
Zuckerbäcker	MALE
Zuckerfabrikant	MALE
Zuckerfabrikation	MALE
Zuckerindustrie	MALE
Zuckerkrankheit	MALE
Zuckerrohr	MALE
Zuckerrohrfeld	MALE
Zuckerrohrplantage	MALE
Zuckerrübe	MALE
Zufall	MALE
Zuffenhausener	MALE
Zuflucht	MALE
Zufluchtsort	MALE
Zufluss	MALE
Zufriedenheit	MALE
Zufuhr	MALE
Zufälligkeit	MALE
Zuführung	MALE
Zug	MALE
Zugabe	MALE
Zugang	MALE
Zugangebot	MALE
Zugangsbarriere	MALE
Zugangsdatei	MALE
Zugangsdatum	MALE
Zugangshindernis	MALE
Zugangsvoraussetzung	FEMALE
Zuganreise	FEMALE
Zugbrücke	FEMALE
Zugdauer	FEMALE
Zugehörigkeit	FEMALE
Zugentlastung	FEMALE
Zugeständnis	FEMALE
Zugewinngemeinschaft	FEMALE
Zugfahren	FEMALE
Zugfahrer	FEMALE
Zugfahrkarte	FEMALE
Zugfahrplan	FEMALE
Zugfahrt	FEMALE
Zugkomposition	FEMALE
Zugnummer	FEMALE
Zugpflegeleiterin	FEMALE
Zugplatz	FEMALE
Zugreise	FEMALE
Zugreservierung	FEMALE
Zugriff	FEMALE
Zugriffsmöglichkeit	FEMALE
Zugriffspause	FEMALE
Zugriffsversuch	FEMALE
Zugriffszeit	FEMALE
Zugrundelegung	FEMALE
Zugstation	FEMALE
Zugstrecke	FEMALE
Zugticket	FEMALE
Zugunglück	FEMALE
Zugverbindung	FEMALE
Zugvogel	FEMALE
Zugzeit	FEMALE
Zugänglichkeit	FEMALE
Zuhilfenahme	FEMALE
Zuhörer	FEMALE
Zukauf	FEMALE
Zukunft	FEMALE
Zukunftsaufgabe	FEMALE
Zukunftsaussicht	FEMALE
Zukunftsbeitrag	FEMALE
Zukunftschance	FEMALE
Zukunftsfeld	FEMALE
Zukunftsfrage	FEMALE
Zukunftsfähigkeit	FEMALE
Zukunftsgestaltung	FEMALE
Zukunftshoffnung	FEMALE
Zukunftsindustrie	FEMALE
Zukunftsinvestition	FEMALE
Zukunftskonzept	FEMALE
Zukunftsmarkt	FEMALE
Zukunftsminister	FEMALE
Zukunftsperspektive	FEMALE
Zukunftsproblem	FEMALE
Zukunftsprojekt	FEMALE
Zukunftssicherung	FEMALE
Zukunftssicherungsleistung	FEMALE
Zukunftssorge	FEMALE
Zukunftsthema	FEMALE
Zukunftsvision	FEMALE
Zukunftswerkstatt	FEMALE
Zulage	FEMALE
Zulagensystem	FEMALE
Zulassung	FEMALE
Zulassungsbedingung	FEMALE
Zulassungsbeschwerde	FEMALE
Zulassungskriterium	FEMALE
Zulassungsverfahren	FEMALE
Zulassungsvoraussetzung	FEMALE
Zulauf	FEMALE
Zulieferbetrieb	FEMALE
Zulieferer	FEMALE
Zulieferindustrie	FEMALE
Zulieferteil	FEMALE
Zulieferung	FEMALE
Zulubewegung	FEMALE
Zuluhäuptling	FEMALE
Zulässigkeit	FEMALE
Zulässigkeit	FEMALE
Zwangsarbeit	FEMALE
Zwangsarbeiter	FEMALE
Zwangsarbeitslager	FEMALE
Zwangseinsatz	FEMALE
Zwangsexmatrikulation	FEMALE
Zwangskollektiv	FEMALE
Zwangslage	FEMALE
Zwangsmaßnahme	FEMALE
Zwangspause	FEMALE
Zwangsräumung	FEMALE
Zwangsvereinigung	FEMALE
Zwangsverschmelzung	FEMALE
Zwangsversteigerung	FEMALE
Zwangsverwalter	FEMALE
Zwangsverwaltung	FEMALE
Zwangsvollstreckung	FEMALE
Zwanzigjährig	FEMALE
Zweck	FEMALE
Zweckbestimmung	FEMALE
Zweckbindung	FEMALE
Zweckentfremdung	FEMALE
Zweckmäßigkeit	FEMALE
Zweckverband	FEMALE
Zwehrenturm	FEMALE
Zwei-	FEMALE
Zwei-	FEMALE
Zwei-	FEMALE
Zwei-	FEMALE
Zwei-	FEMALE
Zwei-	FEMALE
Zwei-	FEMALE
Zwei-	FEMALE
Zwei-	FEMALE
Zwei-	FEMALE
Zweiakter	FEMALE
Zweibahnverkehr	FEMALE
Zweibeiner	FEMALE
Zweidrittel	FEMALE
Zweidrittel-	FEMALE
Zweidrittel-	FEMALE
Zweidrittelmehrheit	FEMALE
Zweier	FEMALE
Zweierrhythmus	FEMALE
Zweifamilienhaus	FEMALE
Zweifel	FEMALE
Zweifel	MALE
Zweifelsfall	MALE
Zweig	MALE
Zweigniederlassung	MALE
Zweigstelle	MALE
Zweigwerk	MALE
Zweijährig	MALE
Zweikampf	MALE
Zweipersonenhaushalt	MALE
Zündstoff	MALE
Zündung	MALE
bestätigungs-	FEMALE
british-	FEMALE
business-	MALE
business-	MALE
colorado	MALE
dekra-	FEMALE
diners-	MALE
drei	FEMALE
drei	FEMALE
drei-	FEMALE
eins	FEMALE
einundzwanzig	FEMALE
ferkelei	MALE
fünf-	MALE
fünf-	MALE
gesetzesvorlage	MALE
gruft	MALE
kanareninsel	FEMALE
lohnnebenkoste	FEMALE
master-	FEMALE
nelson-	MALE
profi-	MALE
rückfahr-	MALE
schwingung	MALE
us-	FEMALE
verbreiterung	FEMALE
vorzeige-	MALE
was	FEMALE
wasserfarb-	MALE
zwanzig	FEMALE
zwei	FEMALE
zwei	FEMALE
Ökostrom	MALE
Ökosystem	MALE
Ökosystem-	MALE
Ökosystementwicklung	MALE
Ökozentrum	MALE
Ökumene	MALE
Überzeugungsarbeit	FEMALE
Überzeugungskraft	FEMALE
Üblich	FEMALE
Übung	FEMALE
Übungsaufgabe	FEMALE
Übungsblatt	FEMALE
Übungsleiter	FEMALE
Übungsleiterin	FEMALE
Übungsmaterial	FEMALE
Übungssaal	FEMALE
